Season_End_Year,Squad,Comp,Player,Nation,Pos,Age,Born,Mins_Per_90,Tkl_Tackles,TklW_Tackles,Def 3rd_Tackles,Mid 3rd_Tackles,Att 3rd_Tackles,Tkl_Challenges,Att_Challenges,Tkl_percent_Challenges,Lost_Challenges,Blocks_Blocks,Sh_Blocks,Pass_Blocks,Int,Tkl+Int,Clr,Err,Url
2023,Almería,La Liga,Sergio Akieme,ESP,DF,24,1997,25.5,27,16,19,6,2,12,22,54.5,10,22,6,16,14,41,41,0,https://fbref.com/en/players/06efa9dc/Sergio-Akieme
2023,Almería,La Liga,Srđan Babić,SRB,DF,26,1996,33.3,28,18,20,8,0,15,32,46.9,17,34,22,12,29,57,124,1,https://fbref.com/en/players/075fe5a3/Srdjan-Babic
2023,Almería,La Liga,Léo Baptistão,BRA,"FW,MF",29,1992,19.2,32,20,13,16,3,13,33,39.4,20,17,2,15,19,51,12,0,https://fbref.com/en/players/35f6db55/Leo-Baptistao
2023,Almería,La Liga,El Bilal Touré,MLI,FW,20,2001,14,4,3,2,1,1,0,3,0,3,6,1,5,1,5,23,0,https://fbref.com/en/players/47c609d5/El-Bilal-Toure
2023,Almería,La Liga,José Carlos Lazo,ESP,"MF,FW",26,1996,0.2,0,0,0,0,0,0,0,NA,0,0,0,0,0,0,0,0,https://fbref.com/en/players/5b93209a/Jose-Carlos-Lazo
2023,Almería,La Liga,Álex Centelles,ESP,DF,24,1997,12.5,22,14,16,3,3,16,22,72.7,6,13,2,11,11,33,40,0,https://fbref.com/en/players/ae852b7d/Alex-Centelles
2023,Almería,La Liga,Chumi,ESP,DF,23,1999,16.5,29,16,18,9,2,14,23,60.9,9,20,7,13,15,44,53,0,https://fbref.com/en/players/2475cf9b/Chumi
2023,Almería,La Liga,Samu Costa,POR,MF,21,2000,22.1,61,31,35,20,6,29,61,47.5,32,29,7,22,37,98,64,4,https://fbref.com/en/players/76c2a023/Samu-Costa
2023,Almería,La Liga,Curro,ESP,MF,26,1996,0.5,2,0,1,1,0,1,2,50,1,0,0,0,0,2,0,0,https://fbref.com/en/players/f9a225f5/Curro
2023,Almería,La Liga,Íñigo Eguaras,ESP,MF,30,1992,10.7,11,8,4,6,1,5,18,27.8,13,9,3,6,6,17,15,0,https://fbref.com/en/players/3e93f8cf/Inigo-Eguaras
2023,Almería,La Liga,Rodrigo Ely,BRA,DF,28,1993,35.1,30,21,26,4,0,18,25,72,7,46,33,13,31,61,203,1,https://fbref.com/en/players/fd47b4f2/Rodrigo-Ely
2023,Almería,La Liga,Adri Embarba,ESP,"FW,MF",30,1992,16.4,50,27,21,26,3,22,46,47.8,24,23,0,23,9,59,9,0,https://fbref.com/en/players/db8f0eba/Adri-Embarba
2023,Almería,La Liga,Fernando,ESP,GK,32,1990,36.5,0,0,0,0,0,0,2,0,2,2,0,2,1,1,20,3,https://fbref.com/en/players/dabb2827/Fernando
2023,Almería,La Liga,Luis Javier Suárez,COL,FW,24,1997,16.6,17,11,5,6,6,6,26,23.1,20,13,3,10,3,20,10,0,https://fbref.com/en/players/eeba07f8/Luis-Javier-Suarez
2023,Almería,La Liga,Kaiky,BRA,DF,18,2004,6.5,5,5,5,0,0,3,7,42.9,4,18,10,8,11,16,28,0,https://fbref.com/en/players/55634fb8/Kaiky
2023,Almería,La Liga,César de la Hoz,ESP,MF,30,1992,18.6,37,20,17,18,2,19,37,51.4,18,26,6,20,13,50,37,0,https://fbref.com/en/players/60abea75/Cesar-de-la-Hoz
2023,Almería,La Liga,Lázaro,BRA,"FW,MF",20,2002,8,4,3,3,0,1,3,15,20,12,16,1,15,2,6,1,0,https://fbref.com/en/players/86ff856b/Lazaro
2023,Almería,La Liga,Diego Mariño,ESP,GK,32,1990,0.5,0,0,0,0,0,0,0,NA,0,0,0,0,0,0,0,0,https://fbref.com/en/players/d9235a45/Diego-Marino
2023,Almería,La Liga,Gonzalo Melero,ESP,MF,28,1994,20.6,32,16,9,18,5,11,39,28.2,28,23,2,21,7,39,19,1,https://fbref.com/en/players/3902e91b/Gonzalo-Melero
2023,Almería,La Liga,Houboulang Mendes,GNB,DF,24,1998,9.8,19,11,16,3,0,11,27,40.7,16,12,2,10,7,26,23,1,https://fbref.com/en/players/1545cf15/Houboulang-Mendes
2023,Almería,La Liga,Marko Milovanović,SRB,FW,18,2003,0.2,0,0,0,0,0,0,0,NA,0,0,0,0,0,0,0,0,https://fbref.com/en/players/1fda2b14/Marko-Milovanovic
2023,Almería,La Liga,Fernando Pacheco,ESP,GK,30,1992,1,0,0,0,0,0,0,0,NA,0,0,0,0,0,0,1,0,https://fbref.com/en/players/97852360/Fernando-Pacheco
2023,Almería,La Liga,Francisco Portillo,ESP,"MF,FW",32,1990,8,13,6,4,5,4,3,16,18.8,13,7,1,6,7,20,8,0,https://fbref.com/en/players/8e010ff4/Francisco-Portillo
2023,Almería,La Liga,Alejandro Pozo Pozo,ESP,DF,23,1999,20.9,37,19,17,17,3,27,53,50.9,26,30,5,25,26,63,45,1,https://fbref.com/en/players/3c16d927/Alejandro-Pozo-Pozo
2023,Almería,La Liga,Arnau Puigmal,ESP,"MF,FW",21,2001,8.5,22,14,10,7,5,12,17,70.6,5,7,0,7,11,33,6,0,https://fbref.com/en/players/39352da2/Arnau-Puigmal
2023,Almería,La Liga,Largie Ramazani,BEL,"FW,MF",21,2001,15.6,15,9,6,3,6,8,27,29.6,19,11,0,11,15,30,10,0,https://fbref.com/en/players/cc9256ef/Largie-Ramazani
2023,Almería,La Liga,Lucas Robertone,ARG,MF,25,1997,31.6,50,28,20,21,9,28,64,43.8,36,45,7,38,46,96,46,1,https://fbref.com/en/players/a8981944/Lucas-Robertone
2023,Almería,La Liga,Umar Sadiq,NGA,FW,25,1997,2.7,0,0,0,0,0,0,1,0,1,2,0,2,0,0,3,0,https://fbref.com/en/players/686cbe7d/Umar-Sadiq
2023,Almería,La Liga,Dyego Sousa,POR,FW,32,1989,5.9,10,6,5,4,1,4,5,80,1,4,2,2,1,11,14,0,https://fbref.com/en/players/e4738e91/Dyego-Sousa
2023,Athletic Club,La Liga,Julen Agirrezabala,ESP,GK,21,2000,7.5,0,0,0,0,0,0,0,NA,0,0,0,0,0,0,2,0,https://fbref.com/en/players/a2c1a8d3/Julen-Agirrezabala
2023,Athletic Club,La Liga,Yeray Álvarez,ESP,DF,27,1995,25.9,34,23,26,7,1,24,31,77.4,7,23,13,10,48,82,101,0,https://fbref.com/en/players/3ecc11d8/Yeray-Alvarez
2023,Athletic Club,La Liga,Adu Ares,ESP,"FW,MF",20,2001,0.9,4,2,2,1,1,4,4,100,0,1,0,1,2,6,1,0,https://fbref.com/en/players/a461f098/Adu-Ares
2023,Athletic Club,La Liga,Mikel Balenziaga,ESP,DF,34,1988,1.3,4,4,1,2,1,4,4,100,0,0,0,0,1,5,2,0,https://fbref.com/en/players/1fe67e86/Mikel-Balenziaga
2023,Athletic Club,La Liga,Yuri Berchiche,ESP,DF,32,1990,26.7,56,32,28,20,8,35,59,59.3,24,37,12,25,40,96,59,1,https://fbref.com/en/players/b6e50615/Yuri-Berchiche
2023,Athletic Club,La Liga,Álex Berenguer,ESP,FW,27,1995,25.5,58,37,17,25,16,23,60,38.3,37,37,4,33,10,68,6,0,https://fbref.com/en/players/dc1c2fce/Alex-Berenguer
2023,Athletic Club,La Liga,Ander Capa,ESP,DF,30,1992,1.2,1,1,1,0,0,1,5,20,4,5,0,5,0,1,2,0,https://fbref.com/en/players/37f1cf47/Ander-Capa
2023,Athletic Club,La Liga,Dani García,ESP,MF,32,1990,16.5,46,27,17,25,4,29,47,61.7,18,21,6,15,19,65,21,1,https://fbref.com/en/players/240d3a0b/Dani-Garcia
2023,Athletic Club,La Liga,Raúl García,ESP,"FW,MF",36,1986,10.7,12,8,3,4,5,5,15,33.3,10,13,1,12,6,18,9,0,https://fbref.com/en/players/b418dbd4/Raul-Garcia
2023,Athletic Club,La Liga,Gorka Guruzeta,ESP,FW,25,1996,15.8,24,20,6,12,6,11,24,45.8,13,23,2,21,4,28,8,0,https://fbref.com/en/players/6b5ea2f4/Gorka-Guruzeta
2023,Athletic Club,La Liga,Ander Herrera,ESP,MF,32,1989,7.7,18,10,8,7,3,6,18,33.3,12,12,3,9,11,29,12,0,https://fbref.com/en/players/436a9dd0/Ander-Herrera
2023,Athletic Club,La Liga,Iñigo Lekue,ESP,DF,29,1993,14.7,24,17,20,4,0,12,19,63.2,7,16,2,14,13,37,31,1,https://fbref.com/en/players/59b7d823/Inigo-Lekue
2023,Athletic Club,La Liga,Óscar de Marcos,ESP,DF,33,1989,31.3,67,33,34,22,11,40,76,52.6,36,42,6,36,29,96,59,0,https://fbref.com/en/players/9f323c71/Oscar-de-Marcos
2023,Athletic Club,La Liga,Iñigo Martínez,ESP,DF,31,1991,14.9,18,8,11,7,0,6,9,66.7,3,17,11,6,18,36,55,0,https://fbref.com/en/players/3fc45c73/Inigo-Martinez
2023,Athletic Club,La Liga,Jon Morcillo,ESP,"FW,MF",23,1998,0.8,1,0,1,0,0,0,1,0,1,0,0,0,1,2,0,0,https://fbref.com/en/players/b7d7f3bf/Jon-Morcillo
2023,Athletic Club,La Liga,Iker Muniain,ESP,"MF,FW",29,1992,18.8,21,16,7,11,3,6,17,35.3,11,10,1,9,4,25,2,0,https://fbref.com/en/players/c05dfb74/Iker-Muniain
2023,Athletic Club,La Liga,Aitor Paredes,ESP,DF,22,2000,9.5,7,6,4,2,1,6,11,54.5,5,11,7,4,14,21,26,0,https://fbref.com/en/players/b906757a/Aitor-Paredes
2023,Athletic Club,La Liga,Oihan Sancet,ESP,MF,22,2000,28.1,27,16,2,19,6,11,37,29.7,26,10,0,10,4,31,9,1,https://fbref.com/en/players/bdb624a3/Oihan-Sancet
2023,Athletic Club,La Liga,Unai Simón,ESP,GK,25,1997,30.5,2,0,2,0,0,1,1,100,0,1,0,1,0,2,9,3,https://fbref.com/en/players/5dcf3e90/Unai-Simon
2023,Athletic Club,La Liga,Unai Vencedor Paris,ESP,MF,21,2000,2.1,3,1,0,3,0,1,6,16.7,5,5,0,5,1,4,1,0,https://fbref.com/en/players/4112ace5/Unai-Vencedor-Paris
2023,Athletic Club,La Liga,Mikel Vesga,ESP,MF,29,1993,28.6,57,35,21,31,5,25,68,36.8,43,39,8,31,36,93,39,3,https://fbref.com/en/players/b0fce72c/Mikel-Vesga
2023,Athletic Club,La Liga,Asier Villalibre,ESP,FW,24,1997,1.1,0,0,0,0,0,0,0,NA,0,0,0,0,0,0,1,0,https://fbref.com/en/players/57be54ec/Asier-Villalibre
2023,Athletic Club,La Liga,Daniel Vivian,ESP,DF,23,1999,26.4,57,32,36,16,5,36,45,80,9,27,14,13,24,81,90,3,https://fbref.com/en/players/ab7bf91d/Daniel-Vivian
2023,Athletic Club,La Liga,Iñaki Williams,GHA,FW,28,1994,31.5,22,16,5,14,3,9,24,37.5,15,18,3,15,7,29,34,0,https://fbref.com/en/players/6a99e0b1/Inaki-Williams
2023,Athletic Club,La Liga,Nico Williams,ESP,FW,20,2002,29.5,31,16,10,15,6,19,41,46.3,22,40,2,38,8,39,14,1,https://fbref.com/en/players/afdc14d7/Nico-Williams
2023,Athletic Club,La Liga,Oier Zarraga,ESP,MF,23,1999,9.5,14,9,5,7,2,8,20,40,12,7,0,7,10,24,5,0,https://fbref.com/en/players/968a1c2f/Oier-Zarraga
2023,Atlético Madrid,La Liga,Pablo Barrios,ESP,MF,19,2003,8,19,10,3,10,6,8,15,53.3,7,12,2,10,9,28,6,1,https://fbref.com/en/players/45736cec/Pablo-Barrios
2023,Atlético Madrid,La Liga,Yannick Carrasco,BEL,"DF,MF",28,1993,25.7,35,14,21,10,4,23,54,42.6,31,23,1,22,12,47,19,0,https://fbref.com/en/players/de39485a/Yannick-Carrasco
2023,Atlético Madrid,La Liga,Ángel Correa,ARG,"FW,MF",27,1995,16.2,12,6,6,3,3,5,16,31.3,11,17,0,17,10,22,6,1,https://fbref.com/en/players/01eb744d/Angel-Correa
2023,Atlético Madrid,La Liga,Matheus Cunha,BRA,"FW,MF",23,1999,4.2,4,1,1,3,0,0,3,0,3,4,1,3,2,6,3,0,https://fbref.com/en/players/dc62b55d/Matheus-Cunha
2023,Atlético Madrid,La Liga,Rodrigo De Paul,ARG,MF,28,1994,21.4,35,21,11,18,6,18,35,51.4,17,20,3,17,8,43,7,0,https://fbref.com/en/players/162efffd/Rodrigo-De-Paul
2023,Atlético Madrid,La Liga,Matt Doherty,IRL,DF,30,1992,0.2,0,0,0,0,0,0,0,NA,0,2,0,2,0,0,0,0,https://fbref.com/en/players/d557d734/Matt-Doherty
2023,Atlético Madrid,La Liga,Felipe,BRA,DF,33,1989,2.2,3,2,1,2,0,2,4,50,2,2,2,0,0,3,7,0,https://fbref.com/en/players/51a3c4c8/Felipe
2023,Atlético Madrid,La Liga,João Félix,POR,"FW,MF",22,1999,7.2,10,7,2,3,5,1,6,16.7,5,1,0,1,3,13,2,0,https://fbref.com/en/players/8aafd64f/Joao-Felix
2023,Atlético Madrid,La Liga,Antonio Gomis,ESP,GK,19,2003,0.1,0,0,0,0,0,0,0,NA,0,0,0,0,0,0,0,0,https://fbref.com/en/players/f0f4671c/Antonio-Gomis
2023,Atlético Madrid,La Liga,Ivo Grbić,CRO,GK,26,1996,10.2,0,0,0,0,0,0,0,NA,0,0,0,0,0,0,9,1,https://fbref.com/en/players/3f034750/Ivo-Grbic
2023,Atlético Madrid,La Liga,Antoine Griezmann,FRA,"FW,MF",31,1991,31.8,49,34,15,23,11,20,66,30.3,46,34,3,31,24,73,31,0,https://fbref.com/en/players/df69b544/Antoine-Griezmann
2023,Atlético Madrid,La Liga,Mario Hermoso,ESP,DF,27,1995,23.4,22,15,14,6,2,9,30,30,21,19,9,10,19,41,85,1,https://fbref.com/en/players/555f3a0b/Mario-Hermoso
2023,Atlético Madrid,La Liga,Koke,ESP,MF,30,1992,28.3,55,38,23,25,7,28,72,38.9,44,35,13,22,20,75,19,0,https://fbref.com/en/players/55126f3b/Koke
2023,Atlético Madrid,La Liga,Geoffrey Kondogbia,CTA,MF,29,1993,11.2,40,23,19,20,1,17,25,68,8,9,1,8,26,66,12,1,https://fbref.com/en/players/cce181df/Geoffrey-Kondogbia
2023,Atlético Madrid,La Liga,Thomas Lemar,FRA,MF,26,1995,13.9,30,18,10,13,7,10,28,35.7,18,12,3,9,7,37,12,0,https://fbref.com/en/players/4dbd0916/Thomas-Lemar
2023,Atlético Madrid,La Liga,Marcos Llorente,ESP,"MF,DF",27,1995,18.9,32,15,16,10,6,17,30,56.7,13,26,2,24,17,49,19,0,https://fbref.com/en/players/02c15616/Marcos-Llorente
2023,Atlético Madrid,La Liga,Reinildo Mandava,MOZ,DF,28,1994,20.6,66,43,46,19,1,38,49,77.6,11,27,12,15,30,96,59,0,https://fbref.com/en/players/c20bdcd7/Reinildo-Mandava
2023,Atlético Madrid,La Liga,José María Giménez,URU,DF,27,1995,26.9,43,25,28,14,1,24,35,68.6,11,37,17,20,24,67,138,1,https://fbref.com/en/players/f0da930c/Jose-Maria-Gimenez
2023,Atlético Madrid,La Liga,Carlos Martín,ESP,"FW,MF",20,2002,0.3,2,2,0,2,0,2,3,66.7,1,0,0,0,1,3,0,0,https://fbref.com/en/players/64035864/Carlos-Martin
2023,Atlético Madrid,La Liga,Memphis,NED,FW,28,1994,3,1,0,0,0,1,0,1,0,1,0,0,0,0,1,0,0,https://fbref.com/en/players/8f696594/Memphis
2023,Atlético Madrid,La Liga,Nahuel Molina,ARG,DF,24,1998,31.9,69,43,38,18,13,39,91,42.9,52,38,7,31,18,87,63,1,https://fbref.com/en/players/23610943/Nahuel-Molina
2023,Atlético Madrid,La Liga,Álvaro Morata,ESP,FW,29,1992,21.1,16,11,4,8,4,3,8,37.5,5,11,3,8,0,16,23,0,https://fbref.com/en/players/129af0db/Alvaro-Morata
2023,Atlético Madrid,La Liga,Saúl Ñíguez,ESP,"MF,DF",27,1994,12.2,42,27,18,18,6,22,37,59.5,15,27,5,22,15,57,29,0,https://fbref.com/en/players/c14bc029/Saul-Niguez
2023,Atlético Madrid,La Liga,Jan Oblak,SVN,GK,29,1993,27.7,0,0,0,0,0,0,0,NA,0,0,0,0,1,1,8,0,https://fbref.com/en/players/ee8508c0/Jan-Oblak
2023,Atlético Madrid,La Liga,Sergio Reguilón,ESP,DF,25,1996,3.4,7,5,5,2,0,5,7,71.4,2,3,0,3,2,9,4,0,https://fbref.com/en/players/3353737a/Sergio-Reguilon
2023,Atlético Madrid,La Liga,Stefan Savić,MNE,DF,31,1991,21.6,39,26,29,7,3,26,39,66.7,13,17,8,9,33,72,67,2,https://fbref.com/en/players/f6ac68c1/Stefan-Savic
2023,Atlético Madrid,La Liga,Axel Witsel,BEL,"DF,MF",33,1989,25.1,36,22,22,11,3,17,31,54.8,14,20,11,9,23,59,76,0,https://fbref.com/en/players/5dfc6ad5/Axel-Witsel
2023,Barcelona,La Liga,Ángel Alarcón,ESP,"FW,MF",18,2004,0.3,0,0,0,0,0,0,2,0,2,0,0,0,0,0,0,0,https://fbref.com/en/players/455c26a4/Angel-Alarcon
2023,Barcelona,La Liga,Jordi Alba,ESP,DF,33,1989,15.8,25,18,13,11,1,12,28,42.9,16,12,5,7,11,36,23,0,https://fbref.com/en/players/4601e194/Jordi-Alba
2023,Barcelona,La Liga,Marcos Alonso,ESP,DF,31,1990,13,15,10,10,5,0,9,12,75,3,14,10,4,11,26,32,0,https://fbref.com/en/players/f4290206/Marcos-Alonso
2023,Barcelona,La Liga,Ronald Araújo,URU,DF,23,1999,20,26,18,12,13,1,6,9,66.7,3,15,7,8,12,38,41,1,https://fbref.com/en/players/2bef2bca/Ronald-Araujo
2023,Barcelona,La Liga,Pierre-Emerick Aubameyang,GAB,FW,33,1989,0.1,0,0,0,0,0,0,0,NA,0,0,0,0,0,0,0,0,https://fbref.com/en/players/d5dd5f1f/Pierre-Emerick-Aubameyang
2023,Barcelona,La Liga,Alejandro Balde,ESP,DF,18,2003,27.5,42,30,22,16,4,24,41,58.5,17,25,3,22,12,54,17,1,https://fbref.com/en/players/5ccc9672/Alejandro-Balde
2023,Barcelona,La Liga,Héctor Bellerín,ESP,DF,27,1995,1.6,2,0,0,2,0,2,3,66.7,1,2,0,2,3,5,2,0,https://fbref.com/en/players/f874dd44/Hector-Bellerin
2023,Barcelona,La Liga,Sergio Busquets,ESP,MF,34,1988,26,58,26,24,26,8,29,51,56.9,22,32,6,26,27,85,36,2,https://fbref.com/en/players/5ab0ea87/Sergio-Busquets
2023,Barcelona,La Liga,Andreas Christensen,DEN,DF,26,1996,19.6,20,15,9,11,0,10,16,62.5,6,14,12,2,21,41,47,0,https://fbref.com/en/players/1cb49278/Andreas-Christensen
2023,Barcelona,La Liga,Ousmane Dembélé,FRA,FW,25,1997,15.7,19,12,4,8,7,4,15,26.7,11,10,1,9,0,19,2,0,https://fbref.com/en/players/b19db005/Ousmane-Dembele
2023,Barcelona,La Liga,Ansu Fati,ESP,FW,19,2002,15.5,16,9,8,4,4,5,18,27.8,13,19,0,19,5,21,6,0,https://fbref.com/en/players/0ba976e4/Ansu-Fati
2023,Barcelona,La Liga,Eric García,ESP,"DF,MF",21,2001,15.7,24,16,16,5,3,9,20,45,11,23,10,13,19,43,36,1,https://fbref.com/en/players/2bed3eab/Eric-Garcia
2023,Barcelona,La Liga,Aleix Garrido,ESP,FW,18,2004,0.1,2,1,1,0,1,1,1,100,0,1,0,1,0,2,0,0,https://fbref.com/en/players/5757adc3/Aleix-Garrido
2023,Barcelona,La Liga,Gavi,ESP,"MF,FW",17,2004,28.1,47,31,7,30,10,21,55,38.2,34,32,5,27,18,65,22,0,https://fbref.com/en/players/19cae58d/Gavi
2023,Barcelona,La Liga,Frenkie de Jong,NED,MF,25,1997,28.2,46,26,16,21,9,17,41,41.5,24,11,1,10,35,81,22,1,https://fbref.com/en/players/1bacc518/Frenkie-de-Jong
2023,Barcelona,La Liga,Franck Kessié,CIV,MF,25,1996,11,15,9,6,6,3,8,18,44.4,10,10,2,8,12,27,11,2,https://fbref.com/en/players/05e19d6a/Franck-Kessie
2023,Barcelona,La Liga,Jules Koundé,FRA,DF,23,1998,27,37,23,18,13,6,21,31,67.7,10,24,9,15,19,56,61,3,https://fbref.com/en/players/4d1666ff/Jules-Kounde
2023,Barcelona,La Liga,Robert Lewandowski,POL,FW,33,1988,31.6,17,11,2,5,10,7,14,50,7,20,0,20,2,19,14,0,https://fbref.com/en/players/8d78e732/Robert-Lewandowski
2023,Barcelona,La Liga,Memphis,NED,FW,28,1994,1.3,1,1,1,0,0,0,1,0,1,0,0,0,0,1,0,0,https://fbref.com/en/players/8f696594/Memphis
2023,Barcelona,La Liga,Pedri,ESP,MF,19,2002,22,39,22,15,17,7,13,45,28.9,32,27,0,27,13,52,8,1,https://fbref.com/en/players/0d9b2d31/Pedri
2023,Barcelona,La Liga,Iñaki Peña,ESP,GK,23,1999,0.8,0,0,0,0,0,0,0,NA,0,0,0,0,0,0,0,1,https://fbref.com/en/players/cc1c5035/Inaki-Pena
2023,Barcelona,La Liga,Gerard Piqué,ESP,DF,35,1987,4.3,5,4,1,4,0,4,4,100,0,2,1,1,2,7,19,0,https://fbref.com/en/players/adfc9123/Gerard-Pique
2023,Barcelona,La Liga,Raphinha,BRA,FW,25,1996,23,29,19,10,7,12,11,31,35.5,20,33,1,32,14,43,11,1,https://fbref.com/en/players/3423f250/Raphinha
2023,Barcelona,La Liga,Chadi Riad,MAR,MF,19,2003,0,0,0,0,0,0,0,0,NA,0,0,0,0,0,0,0,0,https://fbref.com/en/players/b3b9b8b8/Chadi-Riad
2023,Barcelona,La Liga,Sergi Roberto,ESP,"DF,MF",30,1992,14.5,22,15,12,6,4,7,18,38.9,11,15,7,8,11,33,16,0,https://fbref.com/en/players/335fa267/Sergi-Roberto
2023,Barcelona,La Liga,Marc-André ter Stegen,GER,GK,30,1992,37.2,0,0,0,0,0,0,0,NA,0,0,0,0,1,1,7,3,https://fbref.com/en/players/6f51e382/Marc-Andre-ter-Stegen
2023,Barcelona,La Liga,Pablo Torre,ESP,"FW,MF",19,2003,1.6,2,1,0,1,1,2,4,50,2,1,0,1,2,4,1,0,https://fbref.com/en/players/04e531b6/Pablo-Torre
2023,Barcelona,La Liga,Ferrán Torres,ESP,"FW,MF",22,2000,15.5,13,7,4,5,4,5,20,25,15,11,2,9,3,16,5,0,https://fbref.com/en/players/9e1035f8/Ferran-Torres
2023,Barcelona,La Liga,Lamine Yamal,ESP,FW,15,2007,0.1,0,0,0,0,0,0,0,NA,0,0,0,0,0,0,0,0,https://fbref.com/en/players/82ec26c1/Lamine-Yamal
2023,Betis,La Liga,Abner,BRA,DF,22,2000,6.7,12,9,9,2,1,7,16,43.8,9,8,2,6,8,20,24,0,https://fbref.com/en/players/7f9c5d2d/Abner
2023,Betis,La Liga,Paul Akouokou,CIV,"MF,DF",24,1997,5,16,9,13,3,0,13,20,65,7,2,2,0,12,28,17,1,https://fbref.com/en/players/31f5b89b/Paul-Akouokou
2023,Betis,La Liga,Claudio Bravo,CHI,GK,39,1983,12,0,0,0,0,0,0,0,NA,0,0,0,0,2,2,1,1,https://fbref.com/en/players/10072610/Claudio-Bravo
2023,Betis,La Liga,Sergio Canales,ESP,"FW,MF",31,1991,26.7,25,14,10,8,7,14,33,42.4,19,18,0,18,14,39,8,0,https://fbref.com/en/players/a6de370d/Sergio-Canales
2023,Betis,La Liga,William Carvalho,POR,MF,30,1992,27.1,43,27,18,23,2,17,44,38.6,27,27,6,21,16,59,22,0,https://fbref.com/en/players/dee86451/William-Carvalho
2023,Betis,La Liga,Juan Cruz,ESP,FW,22,2000,2,1,0,0,1,0,1,3,33.3,2,1,0,1,0,1,0,0,https://fbref.com/en/players/cc2dd8a5/Juan-Cruz
2023,Betis,La Liga,Fran Delgado,ESP,DF,21,2001,0.1,0,0,0,0,0,0,0,NA,0,0,0,0,0,0,0,0,https://fbref.com/en/players/e7d2a50b/Fran-Delgado
2023,Betis,La Liga,Nabil Fekir,FRA,MF,29,1993,10.7,11,5,3,3,5,2,9,22.2,7,6,2,4,1,12,0,0,https://fbref.com/en/players/bece776f/Nabil-Fekir
2023,Betis,La Liga,Luiz Felipe,ITA,DF,25,1997,19.6,34,23,23,11,0,18,34,52.9,16,43,24,19,28,62,106,0,https://fbref.com/en/players/15d0c248/Luiz-Felipe
2023,Betis,La Liga,Felix Garreta,ESP,DF,18,2004,1,1,0,0,1,0,0,0,NA,0,1,1,0,1,2,4,0,https://fbref.com/en/players/9a26fa06/Felix-Garreta
2023,Betis,La Liga,Édgar González,ESP,DF,25,1997,19.7,28,19,18,7,3,14,27,51.9,13,12,9,3,21,49,120,0,https://fbref.com/en/players/49d028db/Edgar-Gonzalez
2023,Betis,La Liga,Roberto González,ESP,"FW,MF",21,2001,0.6,0,0,0,0,0,0,1,0,1,0,0,0,1,1,0,0,https://fbref.com/en/players/56545648/Roberto-Gonzalez
2023,Betis,La Liga,Andrés Guardado,MEX,MF,35,1986,15.3,41,25,17,20,4,18,43,41.9,25,14,5,9,23,64,29,0,https://fbref.com/en/players/ef322658/Andres-Guardado
2023,Betis,La Liga,Luiz Henrique,BRA,FW,21,2001,20.1,48,34,27,15,6,20,44,45.5,24,22,0,22,14,62,17,0,https://fbref.com/en/players/8059806f/Luiz-Henrique
2023,Betis,La Liga,Borja Iglesias,ESP,FW,29,1993,26.3,8,4,3,3,2,2,13,15.4,11,9,1,8,1,9,17,0,https://fbref.com/en/players/75645f0e/Borja-Iglesias
2023,Betis,La Liga,Joaquín,ESP,"MF,FW",41,1981,5.5,3,3,2,1,0,1,3,33.3,2,7,2,5,4,7,5,0,https://fbref.com/en/players/4c5b14d2/Joaquin
2023,Betis,La Liga,Willian José,BRA,FW,30,1991,8.1,9,6,6,3,0,4,9,44.4,5,4,0,4,1,10,15,0,https://fbref.com/en/players/d87e2cae/Willian-Jose
2023,Betis,La Liga,Juanmi,ESP,FW,29,1993,10.3,14,10,4,7,3,7,31,22.6,24,10,0,10,4,18,4,0,https://fbref.com/en/players/84399660/Juanmi
2023,Betis,La Liga,Juan Miranda,ESP,DF,22,2000,16.4,23,16,16,6,1,14,29,48.3,15,20,7,13,20,43,63,0,https://fbref.com/en/players/ead61f73/Juan-Miranda
2023,Betis,La Liga,Martín Montoya,ESP,DF,31,1991,5,13,8,9,4,0,10,12,83.3,2,6,1,5,9,22,14,1,https://fbref.com/en/players/5cec2487/Martin-Montoya
2023,Betis,La Liga,Álex Moreno,ESP,DF,29,1993,15,29,22,19,10,0,18,36,50,18,17,4,13,17,46,39,0,https://fbref.com/en/players/16e9d0ea/Alex-Moreno
2023,Betis,La Liga,Loren Morón,ESP,FW,28,1993,0.2,2,2,0,1,1,0,0,NA,0,0,0,0,0,2,1,0,https://fbref.com/en/players/3aa4a3be/Loren-Moron
2023,Betis,La Liga,Ayoze Pérez,ESP,"FW,MF",29,1993,15.4,31,15,9,16,6,10,40,25,30,22,0,22,13,44,5,0,https://fbref.com/en/players/819aa8e7/Ayoze-Perez
2023,Betis,La Liga,Germán Pezzella,ARG,DF,31,1991,27.9,41,28,32,9,0,26,38,68.4,12,32,15,17,50,91,129,1,https://fbref.com/en/players/8c725b43/German-Pezzella
2023,Betis,La Liga,Rodri,ESP,"FW,MF",22,2000,17.8,16,11,5,9,2,8,17,47.1,9,10,0,10,13,29,2,0,https://fbref.com/en/players/85bed4ee/Rodri
2023,Betis,La Liga,Guido Rodríguez,ARG,MF,28,1994,31.9,115,75,59,50,6,54,101,53.5,47,58,14,44,42,157,76,1,https://fbref.com/en/players/34e393f2/Guido-Rodriguez
2023,Betis,La Liga,Aitor Ruibal,ESP,"DF,FW",26,1996,16.2,47,29,35,9,3,31,58,53.4,27,17,2,15,24,71,41,0,https://fbref.com/en/players/a55d8df5/Aitor-Ruibal
2023,Betis,La Liga,Víctor Ruiz,ESP,DF,33,1989,6.2,5,3,3,2,0,3,3,100,0,10,7,3,6,11,34,0,https://fbref.com/en/players/b3dc6eca/Victor-Ruiz
2023,Betis,La Liga,Youssouf Sabaly,SEN,DF,29,1993,18.7,45,23,29,14,2,22,33,66.7,11,35,8,27,19,64,52,1,https://fbref.com/en/players/fbbb9269/Youssouf-Sabaly
2023,Betis,La Liga,Rui Silva,POR,GK,28,1994,26,4,1,4,0,0,4,4,100,0,0,0,0,0,4,12,1,https://fbref.com/en/players/ea83bfa6/Rui-Silva
2023,Celta Vigo,La Liga,Joseph Aidoo,GHA,DF,26,1995,34.7,51,36,33,17,1,16,28,57.1,12,26,14,12,31,82,150,0,https://fbref.com/en/players/18abe173/Joseph-Aidoo
2023,Celta Vigo,La Liga,Iago Aspas,ESP,FW,34,1987,31.9,8,4,0,4,4,3,22,13.6,19,10,1,9,7,15,23,0,https://fbref.com/en/players/7dcf86f6/Iago-Aspas
2023,Celta Vigo,La Liga,Fran Beltrán,ESP,MF,23,1999,31.7,34,22,15,14,5,14,55,25.5,41,29,5,24,53,87,35,2,https://fbref.com/en/players/ed5c5fa3/Fran-Beltran
2023,Celta Vigo,La Liga,Franco Cervi,ARG,"MF,DF",28,1994,21,76,46,29,36,11,33,66,50,33,33,1,32,36,112,16,0,https://fbref.com/en/players/5e1028e5/Franco-Cervi
2023,Celta Vigo,La Liga,Carlos Dominguez,ESP,DF,21,2001,1.2,1,1,0,1,0,1,2,50,1,1,1,0,0,1,7,0,https://fbref.com/en/players/3521abfe/Carlos-Dominguez
2023,Celta Vigo,La Liga,Pablo Durán,ESP,"MF,DF",21,2001,0.4,0,0,0,0,0,0,0,NA,0,2,1,1,1,1,2,0,https://fbref.com/en/players/6db116ec/Pablo-Duran
2023,Celta Vigo,La Liga,Javi Galán,ESP,DF,27,1994,35.1,104,72,60,40,4,48,98,49,50,54,5,49,41,145,63,1,https://fbref.com/en/players/a4b00319/Javi-Galan
2023,Celta Vigo,La Liga,Luca de la Torre,USA,MF,24,1998,16.5,28,19,11,14,3,12,32,37.5,20,22,1,21,9,37,6,0,https://fbref.com/en/players/e9241b40/Luca-de-la-Torre
2023,Celta Vigo,La Liga,Hugo Mallo,ESP,DF,31,1991,24,53,29,34,14,5,28,42,66.7,14,28,7,21,24,77,73,0,https://fbref.com/en/players/cb574619/Hugo-Mallo
2023,Celta Vigo,La Liga,Agustín Marchesín,ARG,GK,34,1988,19,0,0,0,0,0,0,1,0,1,0,0,0,0,0,7,0,https://fbref.com/en/players/853b7c48/Agustin-Marchesin
2023,Celta Vigo,La Liga,Fernando Medrano,ESP,DF,22,2000,0.1,2,1,2,0,0,1,1,100,0,0,0,0,1,3,1,0,https://fbref.com/en/players/d854c9d0/Fernando-Medrano
2023,Celta Vigo,La Liga,Óscar Mingueza,ESP,DF,23,1999,14.3,37,21,27,9,1,25,32,78.1,7,10,4,6,12,49,25,0,https://fbref.com/en/players/056269d7/Oscar-Mingueza
2023,Celta Vigo,La Liga,Unai Núñez,ESP,DF,25,1997,35,47,35,29,15,3,18,34,52.9,16,27,17,10,72,119,135,1,https://fbref.com/en/players/be170419/Unai-Nunez
2023,Celta Vigo,La Liga,Gonçalo Paciência,POR,"FW,MF",27,1994,7.4,8,5,0,5,3,2,7,28.6,5,9,1,8,0,8,4,0,https://fbref.com/en/players/962e54cb/Goncalo-Paciencia
2023,Celta Vigo,La Liga,Carles Pérez,ESP,"MF,FW",24,1998,23.8,39,23,12,17,10,22,66,33.3,44,29,3,26,6,45,9,0,https://fbref.com/en/players/a8f21b9f/Carles-Perez
2023,Celta Vigo,La Liga,Óscar Rodríguez Arnaiz,ESP,MF,24,1998,19.7,32,25,12,15,5,13,28,46.4,15,16,2,14,24,56,15,0,https://fbref.com/en/players/19709006/Oscar-Rodriguez-Arnaiz
2023,Celta Vigo,La Liga,Miguel Rodríguez,ESP,"MF,FW",19,2003,2.8,7,5,4,3,0,4,11,36.4,7,6,0,6,1,8,3,0,https://fbref.com/en/players/958d67bb/Miguel-Rodriguez
2023,Celta Vigo,La Liga,Haris Seferović,SUI,FW,30,1992,9.9,6,3,1,4,1,3,8,37.5,5,7,1,6,1,7,6,1,https://fbref.com/en/players/a45eac1f/Haris-Seferovic
2023,Celta Vigo,La Liga,Augusto Solari,ARG,MF,30,1992,2.9,10,6,6,3,1,3,11,27.3,8,5,0,5,4,14,3,0,https://fbref.com/en/players/3ca6106c/Augusto-Solari
2023,Celta Vigo,La Liga,Hugo Sotelo,ESP,MF,18,2003,0.2,0,0,0,0,0,0,0,NA,0,0,0,0,0,0,0,0,https://fbref.com/en/players/3aa74860/Hugo-Sotelo
2023,Celta Vigo,La Liga,Jørgen Strand Larsen,NOR,FW,22,2000,18.9,15,7,3,5,7,7,30,23.3,23,14,5,9,3,18,24,0,https://fbref.com/en/players/f553b2b3/Jorgen-Strand-Larsen
2023,Celta Vigo,La Liga,Williot Swedberg,SWE,MF,18,2004,0.6,3,1,1,0,2,0,0,NA,0,2,0,2,0,3,1,0,https://fbref.com/en/players/184fe4b2/Williot-Swedberg
2023,Celta Vigo,La Liga,Renato Tapia,PER,"MF,DF",27,1995,16.1,47,25,21,21,5,18,37,48.6,19,29,11,18,19,66,37,0,https://fbref.com/en/players/34269bdf/Renato-Tapia
2023,Celta Vigo,La Liga,Kevin Vázquez,ESP,"DF,MF",29,1993,4.9,13,8,5,7,1,8,12,66.7,4,4,1,3,2,15,8,0,https://fbref.com/en/players/ee923664/Kevin-Vazquez
2023,Celta Vigo,La Liga,Gabriel Veiga,ESP,MF,20,2002,25.5,43,19,14,25,4,16,52,30.8,36,30,3,27,21,64,6,0,https://fbref.com/en/players/35a6e5c7/Gabriel-Veiga
2023,Celta Vigo,La Liga,Iván Villar,ESP,GK,25,1997,19,0,0,0,0,0,0,1,0,1,0,0,0,0,0,7,0,https://fbref.com/en/players/cde52ef5/Ivan-Villar
2023,Cádiz,La Liga,Tomás Alarcón,CHI,MF,23,1999,2.5,3,2,0,2,1,1,2,50,1,1,0,1,2,5,2,0,https://fbref.com/en/players/99ea2ddd/Tomas-Alarcon
2023,Cádiz,La Liga,Rubén Alcaraz,ESP,MF,31,1991,22.7,43,31,24,18,1,19,54,35.2,35,23,8,15,19,62,37,0,https://fbref.com/en/players/036bba5f/Ruben-Alcaraz
2023,Cádiz,La Liga,Iván Alejo,ESP,"MF,FW",27,1995,14.6,32,21,19,9,4,17,37,45.9,20,18,3,15,5,37,12,1,https://fbref.com/en/players/3d7e48ce/Ivan-Alejo
2023,Cádiz,La Liga,José Antonio,ESP,"MF,DF",18,2004,0.5,2,1,0,0,2,0,0,NA,0,0,0,0,0,2,0,0,https://fbref.com/en/players/62a583ee/Jose-Antonio
2023,Cádiz,La Liga,Santiago Arzamendia,PAR,"DF,MF",24,1998,5.4,9,8,7,1,1,6,21,28.6,15,11,1,10,2,11,15,1,https://fbref.com/en/players/759d8dd7/Santiago-Arzamendia
2023,Cádiz,La Liga,Antonio Blanco,ESP,MF,22,2000,1.8,6,4,5,1,0,4,6,66.7,2,5,0,5,1,7,3,0,https://fbref.com/en/players/506daeac/Antonio-Blanco
2023,Cádiz,La Liga,Theo Bongonda,COD,"MF,FW",26,1995,21.5,28,20,11,14,3,17,40,42.5,23,21,2,19,6,34,14,0,https://fbref.com/en/players/0da6a13e/Theo-Bongonda
2023,Cádiz,La Liga,Cala,ESP,DF,32,1989,1.5,2,1,1,1,0,1,2,50,1,2,1,1,1,3,12,0,https://fbref.com/en/players/fe05804b/Cala
2023,Cádiz,La Liga,Isaac Carcelen,ESP,DF,29,1993,24.4,69,51,41,22,6,41,63,65.1,22,35,11,24,19,88,80,1,https://fbref.com/en/players/c4b888df/Isaac-Carcelen
2023,Cádiz,La Liga,Víctor Chust,ESP,DF,22,2000,10.7,9,6,7,2,0,4,7,57.1,3,8,3,5,10,19,53,0,https://fbref.com/en/players/ec1a731e/Victor-Chust
2023,Cádiz,La Liga,Mamady Diarra,MLI,"MF,DF",22,2000,0.7,2,1,2,0,0,1,2,50,1,2,0,2,0,2,0,0,https://fbref.com/en/players/80211dc5/Mamady-Diarra
2023,Cádiz,La Liga,Youba Diarra,MLI,MF,24,1998,1.1,3,0,2,1,0,1,5,20,4,7,1,6,2,5,3,0,https://fbref.com/en/players/d61759ec/Youba-Diarra
2023,Cádiz,La Liga,Gonzalo Escalante,ARG,MF,29,1993,12.5,36,24,15,20,1,15,29,51.7,14,18,4,14,17,53,26,1,https://fbref.com/en/players/3f79a1c8/Gonzalo-Escalante
2023,Cádiz,La Liga,Alfonso Espino,URU,DF,30,1992,34.7,87,56,55,20,12,48,96,50,48,52,11,41,48,135,99,3,https://fbref.com/en/players/db001fa9/Alfonso-Espino
2023,Cádiz,La Liga,Fali,ESP,"DF,MF",28,1993,19,27,19,19,8,0,18,29,62.1,11,24,15,9,13,40,70,1,https://fbref.com/en/players/72a84002/Fali
2023,Cádiz,La Liga,Álex Fernández,ESP,"MF,FW",29,1992,17.5,13,7,6,4,3,4,14,28.6,10,14,1,13,8,21,19,0,https://fbref.com/en/players/aa677a35/Alex-Fernandez
2023,Cádiz,La Liga,Carlos García,ESP,DF,22,2000,0.3,0,0,0,0,0,0,0,NA,0,0,0,0,0,0,2,0,https://fbref.com/en/players/661e2822/Carlos-Garcia
2023,Cádiz,La Liga,David Gil,ESP,GK,28,1994,4,0,0,0,0,0,0,0,NA,0,0,0,0,0,0,3,0,https://fbref.com/en/players/fea23125/David-Gil
2023,Cádiz,La Liga,Álvaro Giménez,ESP,FW,31,1991,0.2,0,0,0,0,0,0,1,0,1,0,0,0,0,0,0,0,https://fbref.com/en/players/18017beb/Alvaro-Gimenez
2023,Cádiz,La Liga,Sergi Guardiola,ESP,FW,31,1991,12.9,9,7,0,6,3,3,12,25,9,5,0,5,3,12,7,0,https://fbref.com/en/players/32974271/Sergi-Guardiola
2023,Cádiz,La Liga,Luis Hernández,ESP,DF,33,1989,35,33,21,25,7,1,22,36,61.1,14,31,24,7,31,64,145,0,https://fbref.com/en/players/02d2c436/Luis-Hernandez
2023,Cádiz,La Liga,Jeremías Ledesma,ARG,GK,29,1993,34,3,2,3,0,0,3,7,42.9,4,1,0,1,2,5,23,3,https://fbref.com/en/players/6c4776b1/Jeremias-Ledesma
2023,Cádiz,La Liga,Anthony Lozano,HON,FW,29,1993,16,6,4,1,4,1,1,7,14.3,6,12,1,11,3,9,17,0,https://fbref.com/en/players/38699c72/Anthony-Lozano
2023,Cádiz,La Liga,Awer Mabil,AUS,"MF,FW",26,1995,1.8,2,0,0,1,1,1,3,33.3,2,1,1,0,0,2,1,0,https://fbref.com/en/players/922da988/Awer-Mabil
2023,Cádiz,La Liga,José Mari,ESP,MF,34,1987,4.4,16,7,12,3,1,10,16,62.5,6,3,1,2,5,21,9,0,https://fbref.com/en/players/6f4c734d/Jose-Mari
2023,Cádiz,La Liga,Roger Martí,ESP,FW,31,1991,7.1,6,4,2,3,1,1,8,12.5,7,7,0,7,2,8,7,0,https://fbref.com/en/players/0ae4e09a/Roger-Marti
2023,Cádiz,La Liga,Mamadou Mbaye,SEN,DF,24,1998,8.4,10,7,7,3,0,6,8,75,2,10,8,2,7,17,50,1,https://fbref.com/en/players/8aae94b9/Mamadou-Mbaye
2023,Cádiz,La Liga,Jorge Meré,ESP,DF,25,1997,6.7,11,7,9,2,0,5,8,62.5,3,9,6,3,6,17,32,0,https://fbref.com/en/players/9f979eb2/Jorge-Mere
2023,Cádiz,La Liga,Francisco Mwepu,ZAM,FW,22,2000,0.2,1,0,0,1,0,0,0,NA,0,0,0,0,0,1,0,0,https://fbref.com/en/players/dfe5caa2/Francisco-Mwepu
2023,Cádiz,La Liga,Álvaro Negredo,ESP,FW,36,1985,8.4,5,4,1,2,2,2,2,100,0,4,1,3,0,5,8,0,https://fbref.com/en/players/63b0ca6b/Alvaro-Negredo
2023,Cádiz,La Liga,Brian Ocampo,URU,"MF,FW",23,1999,12.4,18,15,12,5,1,8,21,38.1,13,13,0,13,3,21,3,0,https://fbref.com/en/players/2e3995cd/Brian-Ocampo
2023,Cádiz,La Liga,Raúl Parra,ESP,DF,22,1999,3.4,4,2,4,0,0,4,9,44.4,5,5,3,2,1,5,9,0,https://fbref.com/en/players/647d39d2/Raul-Parra
2023,Cádiz,La Liga,Alberto Perea,ESP,MF,31,1990,0.5,2,0,2,0,0,0,0,NA,0,2,0,2,0,2,0,0,https://fbref.com/en/players/5496cc91/Alberto-Perea
2023,Cádiz,La Liga,Lucas Pérez,ESP,FW,33,1988,7,3,2,2,1,0,1,3,33.3,2,2,0,2,1,4,3,0,https://fbref.com/en/players/a300ac7e/Lucas-Perez
2023,Cádiz,La Liga,Chris Ramos,ESP,FW,25,1997,7.9,12,9,2,7,3,4,11,36.4,7,8,3,5,1,13,19,0,https://fbref.com/en/players/44e07fac/Chris-Ramos
2023,Cádiz,La Liga,Fede San Emeterio,ESP,MF,25,1997,20.5,41,22,23,16,2,22,46,47.8,24,34,14,20,17,58,28,0,https://fbref.com/en/players/efecd633/Fede-San-Emeterio
2023,Cádiz,La Liga,Rubén Sobrino,ESP,"MF,FW",30,1992,27.4,55,37,29,17,9,23,56,41.1,33,33,3,30,24,79,20,1,https://fbref.com/en/players/19b776e9/Ruben-Sobrino
2023,Cádiz,La Liga,Joseba Zaldúa,ESP,DF,30,1992,7.1,15,8,10,4,1,7,10,70,3,4,2,2,11,26,22,0,https://fbref.com/en/players/5ca20b7a/Joseba-Zaldua
2023,Elche,La Liga,Alejandro Alfaro,ESP,MF,20,2002,0.2,0,0,0,0,0,0,0,NA,0,0,0,0,0,0,0,0,https://fbref.com/en/players/b907d169/Alejandro-Alfaro
2023,Elche,La Liga,Édgar Badía,ESP,GK,30,1992,36,1,0,1,0,0,1,2,50,1,0,0,0,0,1,19,3,https://fbref.com/en/players/e4346678/Edgar-Badia
2023,Elche,La Liga,Pedro Bigas,ESP,DF,31,1990,22.4,37,20,30,7,0,18,29,62.1,11,25,14,11,33,70,95,0,https://fbref.com/en/players/697295b1/Pedro-Bigas
2023,Elche,La Liga,Lautaro Blanco,ARG,"DF,MF",23,1999,9.7,16,9,10,4,2,9,26,34.6,17,8,1,7,2,18,10,1,https://fbref.com/en/players/1657f448/Lautaro-Blanco
2023,Elche,La Liga,Lucas Boyé,ARG,FW,26,1996,27.4,36,16,12,16,8,17,35,48.6,18,33,5,28,15,51,46,0,https://fbref.com/en/players/d49f3e6b/Lucas-Boye
2023,Elche,La Liga,Carmona,ESP,"MF,DF",20,2002,6.5,16,9,7,6,3,6,16,37.5,10,14,2,12,8,24,9,0,https://fbref.com/en/players/2dce876a/Carmona
2023,Elche,La Liga,Pape Cheikh Diop,SEN,MF,24,1997,0.4,0,0,0,0,0,0,1,0,1,0,0,0,0,0,0,0,https://fbref.com/en/players/873ce3a2/Pape-Cheikh-Diop
2023,Elche,La Liga,Carlos Clerc,ESP,"DF,MF",30,1992,29.3,75,51,55,16,4,31,50,62,19,29,7,22,28,103,94,1,https://fbref.com/en/players/33a61a52/Carlos-Clerc
2023,Elche,La Liga,Álex Collado,ESP,MF,23,1999,8,26,14,13,11,2,8,13,61.5,5,12,1,11,2,28,4,0,https://fbref.com/en/players/85dace26/Alex-Collado
2023,Elche,La Liga,John Donald,ESP,"MF,DF",21,2000,12.1,20,11,9,9,2,7,14,50,7,14,7,7,14,34,23,1,https://fbref.com/en/players/5e95c000/John-Donald
2023,Elche,La Liga,Nicolás Ezequiel Fernández,ARG,"MF,DF",22,2000,5.7,23,12,10,7,6,9,17,52.9,8,7,0,7,5,28,2,1,https://fbref.com/en/players/3409de86/Nicolas-Ezequiel-Fernandez
2023,Elche,La Liga,Federico Fernández,ARG,DF,33,1989,1,1,1,1,0,0,1,1,100,0,0,0,0,2,3,12,0,https://fbref.com/en/players/f25b010f/Federico-Fernandez
2023,Elche,La Liga,Fidel,ESP,"MF,FW",32,1989,19,15,10,8,5,2,4,38,10.5,34,9,0,9,5,20,8,0,https://fbref.com/en/players/eb82b6f1/Fidel
2023,Elche,La Liga,Diego González,ESP,DF,27,1995,10.6,12,7,9,3,0,7,11,63.6,4,14,12,2,7,19,50,1,https://fbref.com/en/players/4ac7608e/Diego-Gonzalez
2023,Elche,La Liga,Gerard Gumbau,ESP,MF,27,1994,30.4,44,25,17,23,4,18,51,35.3,33,32,8,24,28,72,40,0,https://fbref.com/en/players/ac454a4f/Gerard-Gumbau
2023,Elche,La Liga,Raúl Guti,ESP,MF,25,1996,12.4,18,12,8,9,1,8,18,44.4,10,10,3,7,8,26,6,0,https://fbref.com/en/players/0b2c8585/Raul-Guti
2023,Elche,La Liga,Josan,ESP,"DF,MF",32,1989,12,25,20,20,5,0,14,27,51.9,13,8,0,8,7,32,15,1,https://fbref.com/en/players/5b28b2f6/Josan
2023,Elche,La Liga,Pol Lirola,ESP,DF,24,1997,7,13,6,9,3,1,8,13,61.5,5,3,2,1,7,20,16,0,https://fbref.com/en/players/ff800ed8/Pol-Lirola
2023,Elche,La Liga,Lisandro Magallán,ARG,DF,28,1993,10,19,11,11,5,3,10,12,83.3,2,14,5,9,13,32,30,1,https://fbref.com/en/players/01a49bd2/Lisandro-Magallan
2023,Elche,La Liga,Roger Martí,ESP,FW,31,1991,7.3,5,2,3,2,0,1,5,20,4,4,0,4,1,6,7,0,https://fbref.com/en/players/0ae4e09a/Roger-Marti
2023,Elche,La Liga,Omar Mascarell,EQG,"MF,DF",29,1993,27.2,53,26,32,19,2,31,64,48.4,33,51,19,32,45,98,54,1,https://fbref.com/en/players/11fd2b75/Omar-Mascarell
2023,Elche,La Liga,Pere Milla,ESP,"FW,MF",29,1992,20.5,31,20,18,8,5,14,41,34.1,27,18,3,15,9,40,19,1,https://fbref.com/en/players/335039a2/Pere-Milla
2023,Elche,La Liga,Johan Mojica,COL,"DF,MF",29,1992,3,6,3,5,1,0,2,3,66.7,1,3,2,1,4,10,5,0,https://fbref.com/en/players/608f2092/Johan-Mojica
2023,Elche,La Liga,Tete Morente,ESP,"MF,DF",25,1996,23,33,21,18,13,2,15,36,41.7,21,23,3,20,25,58,28,0,https://fbref.com/en/players/004d185e/Tete-Morente
2023,Elche,La Liga,Randy Nteka,ANG,"FW,MF",24,1997,8.1,15,10,7,6,2,2,11,18.2,9,15,3,12,4,19,9,0,https://fbref.com/en/players/a6103274/Randy-Nteka
2023,Elche,La Liga,Helibelton Palacios,COL,DF,29,1993,21.3,38,20,21,15,2,19,26,73.1,7,26,12,14,20,58,55,0,https://fbref.com/en/players/ac8b2421/Helibelton-Palacios
2023,Elche,La Liga,Javier Pastore,ARG,MF,33,1989,0.1,0,0,0,0,0,0,0,NA,0,0,0,0,0,0,0,0,https://fbref.com/en/players/881ef58c/Javier-Pastore
2023,Elche,La Liga,Ezequiel Ponce,ARG,"FW,MF",25,1997,12.5,9,7,0,6,3,0,7,0,7,6,1,5,1,10,13,0,https://fbref.com/en/players/ccbbe661/Ezequiel-Ponce
2023,Elche,La Liga,Domingos Quina,POR,MF,22,1999,3.1,3,2,2,1,0,1,3,33.3,2,5,0,5,3,6,1,0,https://fbref.com/en/players/41fb0f4e/Domingos-Quina
2023,Elche,La Liga,Enzo Roco,CHI,DF,29,1992,18.4,33,13,23,10,0,15,24,62.5,9,22,15,7,17,50,63,1,https://fbref.com/en/players/37f827ec/Enzo-Roco
2023,Elche,La Liga,Gonzalo Verdú,ESP,DF,33,1988,7.8,10,5,8,2,0,4,8,50,4,8,6,2,10,20,33,0,https://fbref.com/en/players/1c2c55fc/Gonzalo-Verdu
2023,Elche,La Liga,Axel Werner,ARG,GK,26,1996,2,0,0,0,0,0,0,1,0,1,0,0,0,0,0,0,0,https://fbref.com/en/players/c0b1a6da/Axel-Werner
2023,Espanyol,La Liga,Keidi Bare,ALB,MF,24,1997,5.6,15,8,7,5,3,7,13,53.8,6,8,2,6,11,26,8,0,https://fbref.com/en/players/03049c8c/Keidi-Bare
2023,Espanyol,La Liga,Martin Braithwaite,DEN,"FW,MF",31,1991,27.3,12,2,2,4,6,5,14,35.7,9,10,0,10,5,17,11,0,https://fbref.com/en/players/fd771f95/Martin-Braithwaite
2023,Espanyol,La Liga,Leandro Cabrera,URU,DF,31,1991,29.7,46,24,34,12,0,28,43,65.1,15,37,23,14,43,89,114,2,https://fbref.com/en/players/69cbc8b6/Leandro-Cabrera
2023,Espanyol,La Liga,Fernando Calero,ESP,"DF,MF",26,1995,17.9,46,29,27,15,4,21,34,61.8,13,31,13,18,13,59,52,0,https://fbref.com/en/players/41b3069f/Fernando-Calero
2023,Espanyol,La Liga,José Carlos Lazo,ESP,"MF,FW",26,1996,1.8,5,3,2,2,1,3,3,100,0,2,0,2,3,8,5,0,https://fbref.com/en/players/5b93209a/Jose-Carlos-Lazo
2023,Espanyol,La Liga,Sergi Darder,ESP,MF,28,1993,36.9,69,38,12,43,14,29,73,39.7,44,34,2,32,24,93,23,0,https://fbref.com/en/players/070a3904/Sergi-Darder
2023,Espanyol,La Liga,Adri Embarba,ESP,FW,30,1992,0.4,1,0,0,1,0,1,1,100,0,1,0,1,0,1,0,0,https://fbref.com/en/players/db8f0eba/Adri-Embarba
2023,Espanyol,La Liga,Edu Expósito,ESP,MF,25,1996,12.9,34,20,16,15,3,13,23,56.5,10,7,0,7,12,46,20,0,https://fbref.com/en/players/283c7121/Edu-Exposito
2023,Espanyol,La Liga,Álvaro Fernández,ESP,GK,24,1998,11,0,0,0,0,0,0,0,NA,0,0,0,0,0,0,7,2,https://fbref.com/en/players/f127d782/Alvaro-Fernandez
2023,Espanyol,La Liga,Joan García,ESP,GK,21,2001,1,0,0,0,0,0,0,0,NA,0,0,0,0,0,0,0,0,https://fbref.com/en/players/87b498b0/Joan-Garcia
2023,Espanyol,La Liga,Óscar Gil,ESP,DF,25,1997,28.4,63,37,38,16,9,32,61,52.5,29,51,18,33,31,94,55,1,https://fbref.com/en/players/6652cf96/Oscar-Gil
2023,Espanyol,La Liga,Dani Gómez,ESP,"MF,FW",24,1998,1,2,1,1,1,0,1,2,50,1,0,0,0,1,3,0,0,https://fbref.com/en/players/0e5ddc7c/Dani-Gomez
2023,Espanyol,La Liga,Sergi Gómez,ESP,DF,30,1992,26,29,16,20,9,0,18,22,81.8,4,33,19,14,27,56,125,1,https://fbref.com/en/players/bc6f5f06/Sergi-Gomez
2023,Espanyol,La Liga,José Gragera,ESP,"MF,DF",21,2000,5.1,19,9,11,6,2,6,11,54.5,5,10,4,6,7,26,18,0,https://fbref.com/en/players/ee45d138/Jose-Gragera
2023,Espanyol,La Liga,Omar El Hilali,MAR,"DF,MF",18,2003,1,3,2,3,0,0,1,2,50,1,1,0,1,1,4,6,0,https://fbref.com/en/players/139560df/Omar-El-Hilali
2023,Espanyol,La Liga,Joselu,ESP,FW,32,1990,33.2,13,11,3,4,6,4,17,23.5,13,25,4,21,8,21,43,0,https://fbref.com/en/players/6265208f/Joselu
2023,Espanyol,La Liga,Luca Koleosho,ITA,"FW,DF",17,2004,0.7,2,2,0,0,2,1,2,50,1,1,0,1,0,2,0,0,https://fbref.com/en/players/fc076f78/Luca-Koleosho
2023,Espanyol,La Liga,Benjamin Lecomte,FRA,GK,31,1991,10,0,0,0,0,0,0,0,NA,0,0,0,0,0,0,3,2,https://fbref.com/en/players/2fa2a875/Benjamin-Lecomte
2023,Espanyol,La Liga,Pol Lozano,ESP,MF,22,1999,0.2,0,0,0,0,0,0,0,NA,0,1,0,1,0,0,1,0,https://fbref.com/en/players/ea610f00/Pol-Lozano
2023,Espanyol,La Liga,Roger Martínez,ESP,DF,18,2004,0.1,0,0,0,0,0,0,0,NA,0,0,0,0,0,0,0,0,https://fbref.com/en/players/937c6ae6/Roger-Martinez
2023,Espanyol,La Liga,César Montes,MEX,DF,25,1997,17.7,17,9,10,7,0,10,18,55.6,8,19,12,7,14,31,101,0,https://fbref.com/en/players/28e957d7/Cesar-Montes
2023,Espanyol,La Liga,Brian Oliván,ESP,DF,28,1994,26.7,47,27,30,12,5,17,26,65.4,9,26,6,20,22,69,67,0,https://fbref.com/en/players/a3e4bf46/Brian-Olivan
2023,Espanyol,La Liga,Fernando Pacheco,ESP,GK,30,1992,16,0,0,0,0,0,0,1,0,1,0,0,0,1,1,11,0,https://fbref.com/en/players/97852360/Fernando-Pacheco
2023,Espanyol,La Liga,Adrià Pedrosa,ESP,"DF,MF",24,1998,2.5,5,1,5,0,0,4,7,57.1,3,1,1,0,5,10,3,0,https://fbref.com/en/players/112521d1/Adria-Pedrosa
2023,Espanyol,La Liga,Ronaël Pierre-Gabriel,FRA,DF,24,1998,2.6,17,9,12,4,1,5,11,45.5,6,5,2,3,9,26,11,0,https://fbref.com/en/players/64ba07c0/Ronael-Pierre-Gabriel
2023,Espanyol,La Liga,Javi Puado,ESP,"FW,MF",24,1998,26,20,11,12,5,3,12,28,42.9,16,12,2,10,10,30,14,0,https://fbref.com/en/players/2683eda7/Javi-Puado
2023,Espanyol,La Liga,Nico Ribaudo,ESP,"MF,FW",21,2001,13.9,18,13,5,9,4,11,30,36.7,19,19,1,18,5,23,1,0,https://fbref.com/en/players/ce8039aa/Nico-Ribaudo
2023,Espanyol,La Liga,Rubén,ESP,"DF,MF",21,2001,9.9,30,15,18,9,3,20,29,69,9,14,4,10,18,48,18,0,https://fbref.com/en/players/35d4f151/Ruben
2023,Espanyol,La Liga,Simo,ESP,DF,17,2005,1.6,3,1,3,0,0,2,3,66.7,1,5,4,1,0,3,3,0,https://fbref.com/en/players/7f271d74/Simo
2023,Espanyol,La Liga,Vinicius Souza,BRA,MF,23,1999,27,99,66,41,45,13,33,59,55.9,26,31,14,17,48,147,50,1,https://fbref.com/en/players/6a8a7af8/Vinicius-Souza
2023,Espanyol,La Liga,Denis Suárez,ESP,"MF,FW",28,1994,10.5,26,20,12,12,2,13,45,28.9,32,11,1,10,5,31,4,0,https://fbref.com/en/players/12c50af5/Denis-Suarez
2023,Espanyol,La Liga,Nabil Touaizi,MAR,MF,21,2001,0,0,0,0,0,0,0,0,NA,0,0,0,0,0,0,0,0,https://fbref.com/en/players/e96b2583/Nabil-Touaizi
2023,Espanyol,La Liga,Aleix Vidal,ESP,"MF,FW",32,1989,11.4,11,5,6,3,2,4,22,18.2,18,21,2,19,15,26,14,0,https://fbref.com/en/players/04965583/Aleix-Vidal
2023,Getafe,La Liga,Omar Alderete,PAR,DF,25,1996,22.7,35,20,21,14,0,28,40,70,12,23,16,7,26,61,85,0,https://fbref.com/en/players/bb08bce9/Omar-Alderete
2023,Getafe,La Liga,Carles Aleñá,ESP,"MF,FW",24,1998,23.5,18,10,7,5,6,5,34,14.7,29,19,1,18,4,22,18,0,https://fbref.com/en/players/6c811eb7/Carles-Alena
2023,Getafe,La Liga,Ángel Algobia,ESP,MF,23,1999,12.6,27,13,14,13,0,22,48,45.8,26,15,5,10,3,30,11,0,https://fbref.com/en/players/acc1aefa/Angel-Algobia
2023,Getafe,La Liga,Gastón Álvarez,URU,DF,22,2000,16.7,38,30,24,9,5,23,42,54.8,19,15,5,10,15,53,35,0,https://fbref.com/en/players/852ddfb8/Gaston-Alvarez
2023,Getafe,La Liga,Jordan Amavi,FRA,DF,28,1994,2.2,3,2,3,0,0,1,3,33.3,2,3,0,3,4,7,7,0,https://fbref.com/en/players/22721b88/Jordan-Amavi
2023,Getafe,La Liga,Fabrizio Angileri,ARG,DF,28,1994,6.5,12,9,8,3,1,10,17,58.8,7,8,3,5,7,19,10,0,https://fbref.com/en/players/fdd26d71/Fabrizio-Angileri
2023,Getafe,La Liga,Mauro Arambarri,URU,MF,26,1995,11,14,6,9,4,1,3,17,17.6,14,17,5,12,14,28,19,0,https://fbref.com/en/players/58afe001/Mauro-Arambarri
2023,Getafe,La Liga,Djené,TOG,DF,30,1991,31.6,41,28,23,17,1,22,38,57.9,16,25,10,15,42,83,81,1,https://fbref.com/en/players/a4971d84/Djene
2023,Getafe,La Liga,Domingos Duarte,POR,DF,27,1995,29.5,26,18,21,5,0,19,26,73.1,7,29,23,6,39,65,145,0,https://fbref.com/en/players/93090f69/Domingos-Duarte
2023,Getafe,La Liga,Munir El Haddadi,MAR,"MF,FW",26,1995,12.8,12,7,3,7,2,2,10,20,8,23,2,21,9,21,7,0,https://fbref.com/en/players/8696bc90/Munir-El-Haddadi
2023,Getafe,La Liga,Iglesias,ESP,"DF,MF",24,1998,23.8,61,35,40,18,3,33,65,50.8,32,40,5,35,21,82,91,1,https://fbref.com/en/players/974322dc/Iglesias
2023,Getafe,La Liga,Juanmi Latasa,ESP,FW,21,2001,5,5,4,2,0,3,1,1,100,0,3,1,2,1,6,8,0,https://fbref.com/en/players/2bea832e/Juanmi-Latasa
2023,Getafe,La Liga,Nemanja Maksimović,SRB,MF,27,1995,22.8,41,30,17,18,6,19,32,59.4,13,36,14,22,34,75,27,0,https://fbref.com/en/players/00b28772/Nemanja-Maksimovic
2023,Getafe,La Liga,Jaime Mata,ESP,"FW,MF",33,1988,4.9,13,10,4,5,4,7,22,31.8,15,7,2,5,3,16,6,0,https://fbref.com/en/players/02319ad7/Jaime-Mata
2023,Getafe,La Liga,Borja Mayoral,ESP,FW,25,1997,30.7,9,4,7,2,0,5,31,16.1,26,18,0,18,3,12,10,0,https://fbref.com/en/players/64e8ed6d/Borja-Mayoral
2023,Getafe,La Liga,Luis Milla,ESP,MF,27,1994,20.6,48,30,21,18,9,19,44,43.2,25,13,1,12,32,80,25,1,https://fbref.com/en/players/19c36442/Luis-Milla
2023,Getafe,La Liga,Stefan Mitrović,SRB,DF,32,1990,18.7,14,6,12,2,0,7,11,63.6,4,12,10,2,17,31,90,2,https://fbref.com/en/players/e6777e6b/Stefan-Mitrovic
2023,Getafe,La Liga,Moises Parra Gutierrez,ESP,FW,20,2002,0.1,1,0,0,1,0,0,0,NA,0,0,0,0,0,1,0,0,https://fbref.com/en/players/e2dcc60e/Moises-Parra-Gutierrez
2023,Getafe,La Liga,Portu,ESP,"MF,DF",30,1992,19.7,28,21,14,10,4,18,42,42.9,24,23,3,20,17,45,20,1,https://fbref.com/en/players/1bda5842/Portu
2023,Getafe,La Liga,Alejandro Revuelta Montero,ESP,DF,22,2000,0,0,0,0,0,0,0,0,NA,0,0,0,0,0,0,1,0,https://fbref.com/en/players/14d5b7ac/Alejandro-Revuelta-Montero
2023,Getafe,La Liga,Jaime Seoane,ESP,"MF,FW",25,1997,3.6,10,4,3,4,3,2,8,25,6,7,3,4,1,11,2,0,https://fbref.com/en/players/a62b4888/Jaime-Seoane
2023,Getafe,La Liga,David Soria,ESP,GK,29,1993,38,0,0,0,0,0,0,1,0,1,0,0,0,1,1,20,4,https://fbref.com/en/players/8f8c6934/David-Soria
2023,Getafe,La Liga,Damián Suárez,URU,"DF,MF",34,1988,21.6,49,33,23,19,7,26,48,54.2,22,40,0,40,15,64,36,0,https://fbref.com/en/players/ba5004e1/Damian-Suarez
2023,Getafe,La Liga,Enes Ünal,TUR,FW,25,1997,33,26,14,5,19,2,7,25,28,18,19,2,17,6,32,35,0,https://fbref.com/en/players/f8eca1b6/Enes-Unal
2023,Getafe,La Liga,Gonzalo Villar,ESP,MF,24,1998,5.1,10,5,1,6,3,6,14,42.9,8,9,2,7,6,16,5,0,https://fbref.com/en/players/bdc74a8f/Gonzalo-Villar
2023,Girona,La Liga,Ricard Artero,ESP,"MF,FW",19,2003,1.5,3,3,2,1,0,1,1,100,0,2,0,2,1,4,3,0,https://fbref.com/en/players/5d133e96/Ricard-Artero
2023,Girona,La Liga,Santiago Bueno,URU,DF,23,1998,33.4,63,38,43,19,1,24,36,66.7,12,34,22,12,31,94,105,2,https://fbref.com/en/players/edc98fac/Santiago-Bueno
2023,Girona,La Liga,Alexander Callens,PER,DF,30,1992,1.3,3,3,2,1,0,3,4,75,1,3,1,2,1,4,9,0,https://fbref.com/en/players/af34f10d/Alexander-Callens
2023,Girona,La Liga,Juan Carlos,ESP,GK,34,1988,10,0,0,0,0,0,0,0,NA,0,0,0,0,1,1,7,1,https://fbref.com/en/players/688b96e3/Juan-Carlos
2023,Girona,La Liga,Valentín Castellanos,ARG,FW,23,1998,28.9,12,5,2,7,3,0,18,0,18,22,2,20,6,18,26,0,https://fbref.com/en/players/da76bab4/Valentin-Castellanos
2023,Girona,La Liga,Yan Couto,BRA,"DF,MF",20,2002,12.9,25,18,11,11,3,12,20,60,8,7,2,5,5,30,10,0,https://fbref.com/en/players/1944818c/Yan-Couto
2023,Girona,La Liga,Bernardo Espinosa,COL,DF,33,1989,13.6,6,2,2,4,0,3,9,33.3,6,17,10,7,12,18,70,2,https://fbref.com/en/players/4242011c/Bernardo-Espinosa
2023,Girona,La Liga,Valery Fernández,ESP,"MF,DF",22,1999,10.7,12,6,4,6,2,5,9,55.6,4,8,1,7,10,22,9,1,https://fbref.com/en/players/4acd733a/Valery-Fernandez
2023,Girona,La Liga,Aleix García,ESP,MF,25,1997,26,37,20,9,18,10,15,33,45.5,18,24,8,16,31,68,35,1,https://fbref.com/en/players/a10361d2/Aleix-Garcia
2023,Girona,La Liga,Borja García,ESP,"MF,FW",31,1990,7.5,10,4,7,2,1,2,9,22.2,7,3,1,2,5,15,6,1,https://fbref.com/en/players/e7f4603c/Borja-Garcia
2023,Girona,La Liga,Paulo Gazzaniga,ARG,GK,30,1992,28,0,0,0,0,0,0,1,0,1,0,0,0,1,1,9,5,https://fbref.com/en/players/63d17038/Paulo-Gazzaniga
2023,Girona,La Liga,Miguel Gutiérrez,ESP,DF,21,2001,26.6,41,23,23,13,5,23,37,62.2,14,23,5,18,18,59,42,1,https://fbref.com/en/players/7e98cff1/Miguel-Gutierrez
2023,Girona,La Liga,Javi Hernández,ESP,DF,24,1998,12.4,21,12,12,7,2,13,21,61.9,8,10,5,5,7,28,38,0,https://fbref.com/en/players/9a76c2e9/Javi-Hernandez
2023,Girona,La Liga,Yangel Herrera,VEN,"MF,FW",24,1998,10.7,26,9,9,14,3,6,15,40,9,14,1,13,4,30,12,0,https://fbref.com/en/players/5083a734/Yangel-Herrera
2023,Girona,La Liga,Juanpe,ESP,DF,31,1991,15.8,19,11,10,9,0,11,17,64.7,6,12,9,3,10,29,60,1,https://fbref.com/en/players/1633fc8a/Juanpe
2023,Girona,La Liga,David López,ESP,DF,32,1989,18.4,31,18,17,13,1,19,27,70.4,8,29,19,10,14,45,64,1,https://fbref.com/en/players/f03f284b/David-Lopez
2023,Girona,La Liga,Iván Martín,ESP,MF,23,1999,17.6,9,7,4,4,1,8,23,34.8,15,12,0,12,9,18,12,0,https://fbref.com/en/players/ae48c5cb/Ivan-Martin
2023,Girona,La Liga,Arnau Martinez,ESP,DF,19,2003,30.4,69,45,41,19,9,38,85,44.7,47,44,10,34,25,94,54,2,https://fbref.com/en/players/c3e66ffe/Arnau-Martinez
2023,Girona,La Liga,Reinier,BRA,"MF,FW",20,2002,7.2,12,10,7,3,2,2,8,25,6,6,0,6,5,17,4,0,https://fbref.com/en/players/6b21b7b5/Reinier
2023,Girona,La Liga,Rodrigo Riquelme,ESP,"MF,FW",22,2000,24.2,20,8,8,8,4,9,35,25.7,26,16,0,16,11,31,5,0,https://fbref.com/en/players/65154df0/Rodrigo-Riquelme
2023,Girona,La Liga,Joel Roca,ESP,"MF,FW",17,2005,0.9,2,2,2,0,0,2,5,40,3,1,1,0,0,2,1,0,https://fbref.com/en/players/5f21b94c/Joel-Roca
2023,Girona,La Liga,Oriol Romeu,ESP,MF,30,1991,32.8,70,38,36,26,8,26,51,51,25,48,10,38,37,107,54,0,https://fbref.com/en/players/4b511457/Oriol-Romeu
2023,Girona,La Liga,Samuel Sáiz,ESP,MF,31,1991,2.7,2,2,0,2,0,1,2,50,1,3,0,3,0,2,1,1,https://fbref.com/en/players/13e0eb29/Samuel-Saiz
2023,Girona,La Liga,Cristhian Stuani,URU,FW,35,1986,12.1,13,6,2,7,4,5,14,35.7,9,10,0,10,2,15,5,0,https://fbref.com/en/players/220c11f1/Cristhian-Stuani
2023,Girona,La Liga,Ramón Terrats,ESP,MF,21,2000,2.4,4,2,1,3,0,2,6,33.3,4,6,2,4,3,7,3,1,https://fbref.com/en/players/f36016a5/Ramon-Terrats
2023,Girona,La Liga,Viktor Tsyhankov,UKR,MF,24,1997,16.5,8,8,5,1,2,1,14,7.1,13,13,2,11,7,15,12,0,https://fbref.com/en/players/f7e87032/Viktor-Tsyhankov
2023,Girona,La Liga,Oscar Ureña,DOM,MF,19,2003,1.1,4,2,2,2,0,2,3,66.7,1,2,0,2,1,5,0,0,https://fbref.com/en/players/2dd7e29d/Oscar-Urena
2023,Girona,La Liga,Manu Vallejo,ESP,"FW,MF",25,1997,2.3,4,1,1,2,1,1,6,16.7,5,2,0,2,1,5,3,0,https://fbref.com/en/players/0bc4e720/Manu-Vallejo
2023,Girona,La Liga,Toni Villa,ESP,"MF,FW",27,1995,9.9,25,18,9,11,5,10,23,43.5,13,8,0,8,8,33,3,0,https://fbref.com/en/players/636eae97/Toni-Villa
2023,Mallorca,La Liga,Amath,SEN,"MF,FW",26,1996,13.6,29,19,14,8,7,14,22,63.6,8,13,1,12,5,34,5,0,https://fbref.com/en/players/f3b1d9a2/Amath
2023,Mallorca,La Liga,Josep Antoni Gayá,ESP,"DF,MF",22,2000,1.1,0,0,0,0,0,0,0,NA,0,4,2,2,1,1,6,0,https://fbref.com/en/players/4a5f2032/Josep-Antoni-Gaya
2023,Mallorca,La Liga,Ludwig Augustinsson,SWE,DF,28,1994,1.5,2,1,2,0,0,1,3,33.3,2,1,0,1,1,3,3,0,https://fbref.com/en/players/9fec8860/Ludwig-Augustinsson
2023,Mallorca,La Liga,Iddrisu Baba,GHA,"MF,DF",26,1996,18.9,31,17,15,16,0,15,32,46.9,17,18,8,10,11,42,39,0,https://fbref.com/en/players/bfd381b3/Iddrisu-Baba
2023,Mallorca,La Liga,Rodrigo Battaglia,ARG,MF,31,1991,7.6,12,5,7,5,0,6,14,42.9,8,16,7,9,5,17,18,0,https://fbref.com/en/players/d637fc22/Rodrigo-Battaglia
2023,Mallorca,La Liga,Copete,ESP,DF,22,1999,24.5,53,28,35,16,2,26,36,72.2,10,38,17,21,44,97,111,2,https://fbref.com/en/players/0f26ffd7/Copete
2023,Mallorca,La Liga,Jaume Costa,ESP,DF,34,1988,28.9,50,34,26,17,7,29,51,56.9,22,13,5,8,22,72,44,1,https://fbref.com/en/players/808d48f3/Jaume-Costa
2023,Mallorca,La Liga,Braian Cufré,ARG,DF,25,1996,2.4,5,2,2,1,2,2,5,40,3,2,1,1,2,7,1,0,https://fbref.com/en/players/192c89a6/Braian-Cufre
2023,Mallorca,La Liga,Iñigo Ruiz de Galarreta,ESP,MF,28,1993,27.2,54,38,27,23,4,20,52,38.5,32,26,9,17,30,84,19,0,https://fbref.com/en/players/91f7631f/Inigo-Ruiz-de-Galarreta
2023,Mallorca,La Liga,Giovanni González,URU,DF,27,1994,10.3,16,8,11,2,3,9,22,40.9,13,8,2,6,7,23,22,0,https://fbref.com/en/players/1fc474ae/Giovanni-Gonzalez
2023,Mallorca,La Liga,Dominik Greif,SVK,GK,25,1997,1,0,0,0,0,0,0,0,NA,0,0,0,0,0,0,0,0,https://fbref.com/en/players/30061f53/Dominik-Greif
2023,Mallorca,La Liga,Clément Grenier,FRA,MF,31,1991,8,20,8,6,12,2,10,20,50,10,9,1,8,6,26,7,0,https://fbref.com/en/players/8b298f56/Clement-Grenier
2023,Mallorca,La Liga,Dennis Hadzikadunic,BIH,DF,24,1998,6.8,9,6,4,5,0,4,4,100,0,5,4,1,3,12,27,0,https://fbref.com/en/players/82cfae2a/Dennis-Hadzikadunic
2023,Mallorca,La Liga,Lago Junior,CIV,"FW,MF",31,1990,0.6,1,0,0,1,0,1,1,100,0,0,0,0,0,1,0,0,https://fbref.com/en/players/360d70f8/Lago-Junior
2023,Mallorca,La Liga,Tino Kadewere,ZIM,"FW,MF",26,1996,6,6,3,3,3,0,4,9,44.4,5,6,2,4,2,8,1,0,https://fbref.com/en/players/7d08063d/Tino-Kadewere
2023,Mallorca,La Liga,Lee Kang-in,KOR,"MF,FW",21,2001,31.4,42,24,10,22,10,18,61,29.5,43,25,2,23,11,53,7,0,https://fbref.com/en/players/8455ad90/Lee-Kang-in
2023,Mallorca,La Liga,Javier Llabrés,ESP,FW,19,2002,0.2,0,0,0,0,0,0,0,NA,0,0,0,0,0,0,1,0,https://fbref.com/en/players/38b0cf42/Javier-Llabres
2023,Mallorca,La Liga,Pablo Maffeo,ESP,DF,25,1997,33.1,75,46,54,16,5,45,78,57.7,33,38,11,27,26,101,76,0,https://fbref.com/en/players/5db04597/Pablo-Maffeo
2023,Mallorca,La Liga,Manu Morlanes,ESP,MF,23,1999,7.8,22,9,12,8,2,13,24,54.2,11,10,5,5,5,27,9,0,https://fbref.com/en/players/a0255c67/Manu-Morlanes
2023,Mallorca,La Liga,Vedat Muriqi,KVX,FW,28,1994,32.6,12,7,4,7,1,3,13,23.1,10,19,7,12,12,24,73,0,https://fbref.com/en/players/0cadc46d/Vedat-Muriqi
2023,Mallorca,La Liga,Matija Nastasić,SRB,DF,29,1993,10.1,10,8,7,1,2,3,6,50,3,11,4,7,18,28,43,1,https://fbref.com/en/players/f35430a4/Matija-Nastasic
2023,Mallorca,La Liga,Abdón Prats,ESP,"FW,MF",29,1992,4.6,1,0,1,0,0,0,0,NA,0,5,0,5,0,1,2,0,https://fbref.com/en/players/d1b060e2/Abdon-Prats
2023,Mallorca,La Liga,Rubén Quintanilla,ESP,DF,20,2002,0,0,0,0,0,0,0,0,NA,0,1,0,1,0,0,0,0,https://fbref.com/en/players/2f456b86/Ruben-Quintanilla
2023,Mallorca,La Liga,Antonio Raillo,ESP,DF,30,1991,30.7,34,21,23,11,0,10,15,66.7,5,38,29,9,31,65,158,1,https://fbref.com/en/players/b857bd29/Antonio-Raillo
2023,Mallorca,La Liga,Predrag Rajković,SRB,GK,26,1995,36,0,0,0,0,0,0,2,0,2,0,0,0,0,0,16,1,https://fbref.com/en/players/58ad9383/Predrag-Rajkovic
2023,Mallorca,La Liga,Ángel Rodríguez,ESP,"FW,MF",35,1987,4.4,1,1,0,1,0,0,2,0,2,3,0,3,1,2,1,0,https://fbref.com/en/players/8cfc2f69/Angel-Rodriguez
2023,Mallorca,La Liga,Dani Rodríguez,ESP,MF,34,1988,23.3,42,23,18,22,2,21,46,45.7,25,31,8,23,21,63,14,0,https://fbref.com/en/players/70f8e0bd/Dani-Rodriguez
2023,Mallorca,La Liga,Leo Román,ESP,GK,22,2000,1,0,0,0,0,0,0,0,NA,0,0,0,0,0,0,0,0,https://fbref.com/en/players/924ff27e/Leo-Roman
2023,Mallorca,La Liga,Franco Russo,ARG,DF,27,1994,1.6,2,1,2,0,0,0,1,0,1,5,0,5,3,5,5,0,https://fbref.com/en/players/b75ac54b/Franco-Russo
2023,Mallorca,La Liga,Antonio Sánchez,ESP,"MF,DF",25,1997,12,19,8,13,4,2,10,34,29.4,24,18,0,18,22,41,14,1,https://fbref.com/en/players/a254bbe0/Antonio-Sanchez
2023,Mallorca,La Liga,Martin Valjent,SVK,DF,26,1995,29.5,35,27,22,12,1,19,28,67.9,9,39,21,18,29,64,137,0,https://fbref.com/en/players/f2c6ac01/Martin-Valjent
2023,Osasuna,La Liga,Ezequiel Ávila,ARG,"FW,MF",28,1994,19,8,5,2,4,2,6,23,26.1,17,12,1,11,8,16,16,0,https://fbref.com/en/players/253a06b9/Ezequiel-Avila
2023,Osasuna,La Liga,Kike Barja,ESP,"FW,MF",25,1997,14.6,15,9,6,5,4,8,24,33.3,16,7,0,7,4,19,3,0,https://fbref.com/en/players/aad53e64/Kike-Barja
2023,Osasuna,La Liga,Iker Benito,ESP,"FW,MF",19,2002,2,4,3,0,3,1,2,4,50,2,0,0,0,2,6,4,0,https://fbref.com/en/players/50cbc806/Iker-Benito
2023,Osasuna,La Liga,Darko Brašanac,SRB,MF,30,1992,11.6,29,20,12,10,7,12,23,52.2,11,14,2,12,12,41,9,0,https://fbref.com/en/players/4accb7e0/Darko-Brasanac
2023,Osasuna,La Liga,Ante Budimir,CRO,FW,31,1991,20,19,9,0,12,7,2,10,20,8,10,0,10,5,24,19,0,https://fbref.com/en/players/8f3565b3/Ante-Budimir
2023,Osasuna,La Liga,Juan Cruz Armada,ESP,DF,30,1992,22.9,24,14,17,4,3,13,23,56.5,10,21,8,13,13,37,58,0,https://fbref.com/en/players/a56da3ba/Juan-Cruz-Armada
2023,Osasuna,La Liga,Abde Ezzalzouli,MAR,"FW,MF",20,2001,16.7,29,19,13,12,4,13,23,56.5,10,20,0,20,4,33,6,0,https://fbref.com/en/players/bed68338/Abde-Ezzalzouli
2023,Osasuna,La Liga,Aitor Fernández,ESP,GK,31,1991,21,1,1,1,0,0,0,1,0,1,0,0,0,2,3,17,0,https://fbref.com/en/players/a01c3d54/Aitor-Fernandez
2023,Osasuna,La Liga,David García,ESP,DF,28,1994,29.8,34,20,22,12,0,19,22,86.4,3,28,13,15,45,79,151,0,https://fbref.com/en/players/3e42f707/David-Garcia
2023,Osasuna,La Liga,Rubén García,ESP,"FW,MF",29,1993,12.9,20,11,12,4,4,7,24,29.2,17,14,1,13,12,32,13,0,https://fbref.com/en/players/5c96b017/Ruben-Garcia
2023,Osasuna,La Liga,Unai García,ESP,DF,30,1992,19,23,13,13,8,2,12,17,70.6,5,23,14,9,19,42,60,2,https://fbref.com/en/players/4a633cfe/Unai-Garcia
2023,Osasuna,La Liga,Moi Gómez,ESP,"MF,FW",28,1994,27.3,26,17,9,14,3,15,32,46.9,17,15,3,12,10,36,5,1,https://fbref.com/en/players/5a626448/Moi-Gomez
2023,Osasuna,La Liga,Aridane Hernández,ESP,DF,33,1989,19.9,21,15,17,4,0,12,25,48,13,34,21,13,28,49,96,1,https://fbref.com/en/players/132ac341/Aridane-Hernandez
2023,Osasuna,La Liga,Jorge Herrando,ESP,DF,21,2001,0.3,0,0,0,0,0,0,0,NA,0,1,0,1,0,0,3,0,https://fbref.com/en/players/e19c989c/Jorge-Herrando
2023,Osasuna,La Liga,Sergio Herrera,ESP,GK,29,1993,17,2,0,2,0,0,2,2,100,0,1,0,1,1,3,6,2,https://fbref.com/en/players/a4995f48/Sergio-Herrera
2023,Osasuna,La Liga,Pablo Ibáñez,ESP,MF,23,1998,11.8,29,13,7,17,5,12,35,34.3,23,19,2,17,8,37,24,0,https://fbref.com/en/players/3701906c/Pablo-Ibanez
2023,Osasuna,La Liga,Kiké,ESP,FW,32,1989,11.3,6,3,0,4,2,2,5,40,3,6,1,5,1,7,13,0,https://fbref.com/en/players/e897d8ba/Kike
2023,Osasuna,La Liga,Jon Moncayola,ESP,"MF,DF",24,1998,27.2,55,39,24,22,9,30,76,39.5,46,37,5,32,17,72,32,2,https://fbref.com/en/players/9939e168/Jon-Moncayola
2023,Osasuna,La Liga,Diego Moreno,ESP,DF,21,2001,7.1,4,4,2,2,0,3,8,37.5,5,7,4,3,5,9,21,0,https://fbref.com/en/players/a21417e2/Diego-Moreno
2023,Osasuna,La Liga,Iker Muñoz,ESP,MF,19,2002,2.8,1,0,0,1,0,0,3,0,3,2,1,1,3,4,8,0,https://fbref.com/en/players/175ece4c/Iker-Munoz
2023,Osasuna,La Liga,Aimar Oroz,ESP,"MF,FW",20,2001,22.4,26,14,8,10,8,8,30,26.7,22,24,1,23,24,50,6,0,https://fbref.com/en/players/7c363088/Aimar-Oroz
2023,Osasuna,La Liga,Rubén Peña,ESP,"DF,MF",31,1991,14.2,32,18,10,18,4,20,41,48.8,21,23,8,15,17,49,31,0,https://fbref.com/en/players/1f079188/Ruben-Pena
2023,Osasuna,La Liga,Manu Sánchez,ESP,DF,21,2000,23.6,51,35,35,9,7,33,63,52.4,30,33,5,28,14,65,51,0,https://fbref.com/en/players/ffacd3d5/Manu-Sanchez
2023,Osasuna,La Liga,Roberto Torres,ESP,"FW,MF",33,1989,0.1,0,0,0,0,0,0,0,NA,0,0,0,0,0,0,0,0,https://fbref.com/en/players/d733aa38/Roberto-Torres
2023,Osasuna,La Liga,Lucas Torró,ESP,MF,28,1994,27.5,48,32,28,15,5,18,42,42.9,24,24,3,21,42,90,64,1,https://fbref.com/en/players/0e4fef6e/Lucas-Torro
2023,Osasuna,La Liga,Nacho Vidal,ESP,DF,27,1995,13.9,27,14,16,6,5,17,32,53.1,15,17,4,13,19,46,33,1,https://fbref.com/en/players/3a9c4b7b/Nacho-Vidal
2023,Rayo Vallecano,La Liga,Iván Balliu,ALB,DF,30,1992,35.9,52,29,26,20,6,18,30,60,12,26,3,23,25,77,72,1,https://fbref.com/en/players/cee88597/Ivan-Balliu
2023,Rayo Vallecano,La Liga,Bebé,CPV,FW,32,1990,0.7,0,0,0,0,0,0,2,0,2,1,0,1,0,0,0,0,https://fbref.com/en/players/d8712bf9/Bebe
2023,Rayo Vallecano,La Liga,Sergio Camello,ESP,FW,21,2001,26.7,16,10,3,9,4,5,17,29.4,12,9,1,8,2,18,26,0,https://fbref.com/en/players/873619c6/Sergio-Camello
2023,Rayo Vallecano,La Liga,Catena,ESP,DF,27,1994,34.5,29,14,23,4,2,13,27,48.1,14,32,25,7,28,57,159,1,https://fbref.com/en/players/274ab13c/Catena
2023,Rayo Vallecano,La Liga,Pep Chavarría,ESP,"FW,MF",24,1998,4.1,6,4,2,1,3,1,5,20,4,8,0,8,2,8,8,0,https://fbref.com/en/players/63c5e56b/Pep-Chavarria
2023,Rayo Vallecano,La Liga,Pathé Ciss,SEN,"MF,DF",28,1994,14.2,39,29,11,23,5,15,34,44.1,19,23,10,13,22,61,34,0,https://fbref.com/en/players/9a0408b6/Pathe-Ciss
2023,Rayo Vallecano,La Liga,Santi Comesaña,ESP,MF,25,1996,27.2,71,44,24,41,6,38,82,46.3,44,39,3,36,32,103,17,0,https://fbref.com/en/players/5ae499d0/Santi-Comesana
2023,Rayo Vallecano,La Liga,Stole Dimitrievski,MKD,GK,28,1993,36.9,1,0,1,0,0,1,2,50,1,2,0,2,1,2,17,3,https://fbref.com/en/players/fc70e345/Stole-Dimitrievski
2023,Rayo Vallecano,La Liga,Radamel Falcao,COL,"FW,MF",36,1986,6.8,4,4,1,3,0,1,8,12.5,7,5,1,4,2,6,10,0,https://fbref.com/en/players/66116290/Radamel-Falcao
2023,Rayo Vallecano,La Liga,Álvaro García,ESP,"FW,MF",29,1992,31.9,49,28,21,13,15,11,33,33.3,22,41,4,37,34,83,24,1,https://fbref.com/en/players/90bbd822/Alvaro-Garcia
2023,Rayo Vallecano,La Liga,Fran Garcia,ESP,DF,22,1999,37.9,84,54,53,23,8,55,96,57.3,41,49,8,41,44,128,66,0,https://fbref.com/en/players/7226539b/Fran-Garcia
2023,Rayo Vallecano,La Liga,Mario Hernández,ESP,DF,23,1999,1.1,3,2,2,1,0,3,7,42.9,4,2,0,2,2,5,0,0,https://fbref.com/en/players/90162357/Mario-Hernandez
2023,Rayo Vallecano,La Liga,Florian Lejeune,FRA,DF,31,1991,28.5,28,17,19,8,1,17,25,68,8,24,16,8,15,43,123,0,https://fbref.com/en/players/6eaed4eb/Florian-Lejeune
2023,Rayo Vallecano,La Liga,Diego López,ESP,GK,40,1981,1.1,0,0,0,0,0,0,0,NA,0,0,0,0,0,0,0,1,https://fbref.com/en/players/73683fa9/Diego-Lopez
2023,Rayo Vallecano,La Liga,Unai López,ESP,MF,26,1995,13.9,32,20,10,17,5,13,37,35.1,24,12,1,11,15,47,6,1,https://fbref.com/en/players/88050721/Unai-Lopez
2023,Rayo Vallecano,La Liga,Andrés Martín,ESP,"FW,MF",23,1999,2.3,4,2,2,1,1,3,5,60,2,2,0,2,1,5,2,0,https://fbref.com/en/players/2ae30661/Andres-Martin
2023,Rayo Vallecano,La Liga,Diego Méndez,ESP,MF,18,2003,0,0,0,0,0,0,0,0,NA,0,0,0,0,1,1,0,0,https://fbref.com/en/players/b151a3f2/Diego-Mendez
2023,Rayo Vallecano,La Liga,Abdul Mumin,GHA,DF,24,1998,10.2,11,9,5,6,0,3,7,42.9,4,13,5,8,9,20,36,2,https://fbref.com/en/players/5487adcd/Abdul-Mumin
2023,Rayo Vallecano,La Liga,Pablo Muñoz,ESP,MF,18,2003,0.1,0,0,0,0,0,0,1,0,1,0,0,0,0,0,0,0,https://fbref.com/en/players/44e8521b/Pablo-Munoz
2023,Rayo Vallecano,La Liga,Randy Nteka,ANG,"FW,MF",24,1997,1.3,4,2,2,2,0,1,1,100,0,2,0,2,2,6,3,0,https://fbref.com/en/players/a6103274/Randy-Nteka
2023,Rayo Vallecano,La Liga,Isaac Palazón Camacho,ESP,"FW,MF",27,1994,32.9,45,30,11,23,11,24,66,36.4,42,42,3,39,17,62,30,0,https://fbref.com/en/players/49dbab27/Isaac-Palazon-Camacho
2023,Rayo Vallecano,La Liga,José Pozo,ESP,"MF,FW",26,1996,1,2,2,0,2,0,0,0,NA,0,0,0,0,1,3,1,0,https://fbref.com/en/players/fc8b614b/Jose-Pozo
2023,Rayo Vallecano,La Liga,Salvi,ESP,"FW,MF",31,1991,5.4,13,8,5,5,3,2,8,25,6,0,0,0,2,15,2,0,https://fbref.com/en/players/405f267a/Salvi
2023,Rayo Vallecano,La Liga,Esteban Saveljich,MNE,FW,31,1991,0,0,0,0,0,0,0,0,NA,0,0,0,0,0,0,0,0,https://fbref.com/en/players/79f2a5f5/Esteban-Saveljich
2023,Rayo Vallecano,La Liga,Mario Suárez,ESP,"MF,DF",35,1987,0.1,0,0,0,0,0,0,0,NA,0,1,0,1,0,0,0,0,https://fbref.com/en/players/7106f0a0/Mario-Suarez
2023,Rayo Vallecano,La Liga,Raúl de Tomás,ESP,FW,27,1994,8.9,3,2,0,1,2,2,6,33.3,4,4,0,4,0,3,6,0,https://fbref.com/en/players/02ef8778/Raul-de-Tomas
2023,Rayo Vallecano,La Liga,Óscar Trejo,ARG,"MF,FW",34,1988,23.8,48,32,12,23,13,9,44,20.5,35,31,3,28,8,56,8,1,https://fbref.com/en/players/fc647b34/Oscar-Trejo
2023,Rayo Vallecano,La Liga,Óscar Valentín,ESP,MF,27,1994,28.4,92,51,29,50,13,46,121,38,75,60,9,51,44,136,30,0,https://fbref.com/en/players/592f3158/Oscar-Valentin
2023,Real Madrid,La Liga,David Alaba,AUT,DF,30,1992,20.4,15,11,8,4,3,9,15,60,6,18,9,9,14,29,37,1,https://fbref.com/en/players/05439de2/David-Alaba
2023,Real Madrid,La Liga,Sergio Arribas,ESP,"MF,FW",20,2001,0.2,0,0,0,0,0,0,0,NA,0,1,0,1,0,0,0,0,https://fbref.com/en/players/1e465e70/Sergio-Arribas
2023,Real Madrid,La Liga,Marco Asensio,ESP,"FW,MF",26,1996,16,16,10,8,6,2,8,19,42.1,11,8,3,5,5,21,4,0,https://fbref.com/en/players/45af8a54/Marco-Asensio
2023,Real Madrid,La Liga,Karim Benzema,FRA,FW,34,1987,22.6,9,5,2,4,3,2,11,18.2,9,11,0,11,2,11,5,0,https://fbref.com/en/players/70d74ece/Karim-Benzema
2023,Real Madrid,La Liga,Eduardo Camavinga,FRA,"MF,DF",19,2002,22.3,68,48,32,21,15,24,64,37.5,40,24,5,19,17,85,25,0,https://fbref.com/en/players/7b9c2d84/Eduardo-Camavinga
2023,Real Madrid,La Liga,Dani Carvajal,ESP,DF,30,1992,19.8,32,18,15,12,5,18,35,51.4,17,24,6,18,15,47,49,0,https://fbref.com/en/players/4958bfb2/Dani-Carvajal
2023,Real Madrid,La Liga,Casemiro,BRA,MF,30,1992,0.1,0,0,0,0,0,0,0,NA,0,0,0,0,0,0,1,0,https://fbref.com/en/players/4d224fe8/Casemiro
2023,Real Madrid,La Liga,Dani Ceballos,ESP,MF,25,1996,17.4,43,29,13,15,15,25,64,39.1,39,23,2,21,25,68,6,1,https://fbref.com/en/players/c0617e2b/Dani-Ceballos
2023,Real Madrid,La Liga,Thibaut Courtois,BEL,GK,30,1992,31,1,0,1,0,0,1,1,100,0,0,0,0,3,4,7,1,https://fbref.com/en/players/1840e36d/Thibaut-Courtois
2023,Real Madrid,La Liga,Eden Hazard,BEL,FW,31,1991,2.2,0,0,0,0,0,0,2,0,2,1,0,1,1,1,0,0,https://fbref.com/en/players/a39bb753/Eden-Hazard
2023,Real Madrid,La Liga,Vinicius Júnior,BRA,FW,22,2000,31.4,30,21,10,12,8,14,39,35.9,25,24,1,23,6,36,1,0,https://fbref.com/en/players/7111d552/Vinicius-Junior
2023,Real Madrid,La Liga,Toni Kroos,GER,MF,32,1990,23.9,51,32,16,33,2,23,69,33.3,46,23,4,19,24,75,11,0,https://fbref.com/en/players/6ce1f46f/Toni-Kroos
2023,Real Madrid,La Liga,Andriy Lunin,UKR,GK,23,1999,7,0,0,0,0,0,0,0,NA,0,0,0,0,0,0,1,0,https://fbref.com/en/players/3061e1ec/Andriy-Lunin
2023,Real Madrid,La Liga,Mariano,DOM,FW,28,1993,1.7,1,0,0,1,0,0,0,NA,0,1,0,1,0,1,0,0,https://fbref.com/en/players/5c4dc0ff/Mariano
2023,Real Madrid,La Liga,Ferland Mendy,FRA,DF,27,1995,15,21,12,14,6,1,12,20,60,8,7,2,5,14,35,16,0,https://fbref.com/en/players/3cefcaef/Ferland-Mendy
2023,Real Madrid,La Liga,Éder Militão,BRA,DF,24,1998,30,46,32,25,18,3,26,33,78.8,7,67,39,28,42,88,104,2,https://fbref.com/en/players/2784f898/Eder-Militao
2023,Real Madrid,La Liga,Luka Modrić,CRO,MF,36,1985,19.4,19,9,6,6,7,10,25,40,15,15,5,10,10,29,7,0,https://fbref.com/en/players/6025fab1/Luka-Modric
2023,Real Madrid,La Liga,Nacho,ESP,DF,32,1990,18.2,24,16,17,5,2,12,29,41.4,17,11,6,5,18,42,37,0,https://fbref.com/en/players/2946f9a1/Nacho
2023,Real Madrid,La Liga,Álvaro Odriozola,ESP,DF,26,1995,0.4,0,0,0,0,0,0,0,NA,0,0,0,0,0,0,0,0,https://fbref.com/en/players/1d1691ad/Alvaro-Odriozola
2023,Real Madrid,La Liga,Álvaro Rodríguez,URU,FW,18,2004,0.9,2,1,1,0,1,1,1,100,0,0,0,0,0,2,1,0,https://fbref.com/en/players/49a6ecbb/Alvaro-Rodriguez
2023,Real Madrid,La Liga,Rodrygo,BRA,"FW,MF",21,2001,26.4,17,10,3,7,7,4,23,17.4,19,23,0,23,8,25,5,0,https://fbref.com/en/players/8f5e92a6/Rodrygo
2023,Real Madrid,La Liga,Antonio Rüdiger,GER,DF,29,1993,26.8,18,16,12,5,1,14,23,60.9,9,23,13,10,19,37,74,0,https://fbref.com/en/players/18b896d6/Antonio-Rudiger
2023,Real Madrid,La Liga,Aurélien Tchouaméni,FRA,MF,22,2000,23.5,64,40,23,36,5,23,38,60.5,15,20,6,14,49,113,50,0,https://fbref.com/en/players/4f255115/Aurelien-Tchouameni
2023,Real Madrid,La Liga,Jesús Vallejo,ESP,DF,25,1997,0.2,0,0,0,0,0,0,0,NA,0,0,0,0,0,0,0,0,https://fbref.com/en/players/c2111b45/Jesus-Vallejo
2023,Real Madrid,La Liga,Federico Valverde,URU,"MF,FW",24,1998,27.8,31,20,14,11,6,13,26,50,13,31,4,27,17,48,15,0,https://fbref.com/en/players/0959c2a2/Federico-Valverde
2023,Real Madrid,La Liga,Lucas Vázquez,ESP,DF,31,1991,12.7,34,23,22,10,2,20,28,71.4,8,10,0,10,7,41,13,0,https://fbref.com/en/players/fd51b456/Lucas-Vazquez
2023,Real Sociedad,La Liga,Mohamed Ali Cho,FRA,"FW,MF",18,2004,6.5,13,10,6,5,2,4,10,40,6,9,0,9,2,15,2,0,https://fbref.com/en/players/f8405304/Mohamed-Ali-Cho
2023,Real Sociedad,La Liga,Ander Barrenetxea,ESP,"FW,DF",20,2001,9.8,21,15,15,6,0,12,28,42.9,16,15,1,14,5,26,7,0,https://fbref.com/en/players/200e89e1/Ander-Barrenetxea
2023,Real Sociedad,La Liga,Aritz Elustondo,ESP,DF,28,1994,16.1,26,17,15,10,1,14,26,53.8,12,15,6,9,20,46,43,1,https://fbref.com/en/players/f7dc2ae5/Aritz-Elustondo
2023,Real Sociedad,La Liga,Carlos Fernández,ESP,FW,26,1996,7,6,4,1,3,2,1,15,6.7,14,1,0,1,1,7,4,0,https://fbref.com/en/players/e08647d6/Carlos-Fernandez
2023,Real Sociedad,La Liga,Andoni Gorosabel,ESP,DF,25,1996,19,41,25,23,9,9,26,43,60.5,17,21,2,19,17,58,23,0,https://fbref.com/en/players/6f5f82c0/Andoni-Gorosabel
2023,Real Sociedad,La Liga,Ander Guevara,ESP,MF,25,1997,2.5,5,2,2,2,1,1,4,25,3,6,1,5,2,7,3,0,https://fbref.com/en/players/8e48dc61/Ander-Guevara
2023,Real Sociedad,La Liga,Asier Illarramendi,ESP,MF,32,1990,12,36,18,10,22,4,16,44,36.4,28,27,8,19,18,54,20,0,https://fbref.com/en/players/5ce0b5ba/Asier-Illarramendi
2023,Real Sociedad,La Liga,Alexander Isak,SWE,FW,22,1999,1.7,1,1,0,0,1,0,0,NA,0,0,0,0,0,1,2,0,https://fbref.com/en/players/8e92be30/Alexander-Isak
2023,Real Sociedad,La Liga,Jon Karrikaburu,ESP,FW,19,2002,1,1,0,0,1,0,0,0,NA,0,2,0,2,0,1,0,0,https://fbref.com/en/players/211589b8/Jon-Karrikaburu
2023,Real Sociedad,La Liga,Takefusa Kubo,JPN,"FW,MF",21,2001,27.1,44,26,18,16,10,16,38,42.1,22,29,1,28,9,53,4,0,https://fbref.com/en/players/16aa3654/Takefusa-Kubo
2023,Real Sociedad,La Liga,Robin Le Normand,ESP,DF,25,1996,31.1,36,23,25,9,2,14,27,51.9,13,22,14,8,33,69,93,0,https://fbref.com/en/players/9a64e67e/Robin-Le-Normand
2023,Real Sociedad,La Liga,Jon Magunacelaya,ESP,"MF,FW",22,2000,0.7,1,0,0,0,1,0,2,0,2,0,0,0,0,1,1,0,https://fbref.com/en/players/d4808594/Jon-Magunacelaya
2023,Real Sociedad,La Liga,Pablo Marín,ESP,"MF,FW",19,2003,4,10,5,5,4,1,2,7,28.6,5,1,0,1,4,14,2,0,https://fbref.com/en/players/a83c19cf/Pablo-Marin
2023,Real Sociedad,La Liga,Ander Martin,ESP,"MF,FW",21,2000,0.5,2,2,1,1,0,1,4,25,3,0,0,0,0,2,1,0,https://fbref.com/en/players/e1e75690/Ander-Martin
2023,Real Sociedad,La Liga,Brais Méndez,ESP,MF,25,1997,26.7,58,34,18,30,10,24,64,37.5,40,27,3,24,12,70,14,1,https://fbref.com/en/players/c9e39d91/Brais-Mendez
2023,Real Sociedad,La Liga,Mikel Merino,ESP,MF,26,1996,27.7,77,49,28,33,16,31,62,50,31,38,8,30,20,97,51,1,https://fbref.com/en/players/d080ed5e/Mikel-Merino
2023,Real Sociedad,La Liga,Aihen Muñoz,ESP,DF,24,1997,19.5,38,23,17,17,4,22,47,46.8,25,26,5,21,9,47,38,0,https://fbref.com/en/players/228b0d9d/Aihen-Munoz
2023,Real Sociedad,La Liga,Roberto Navarro,ESP,"MF,FW",20,2002,3.9,5,4,4,0,1,1,2,50,1,7,0,7,2,7,2,0,https://fbref.com/en/players/c997b942/Roberto-Navarro
2023,Real Sociedad,La Liga,Olasagasti,ESP,"MF,DF",21,2000,0.7,4,4,1,2,1,1,2,50,1,2,0,2,0,4,1,0,https://fbref.com/en/players/3d99999d/Olasagasti
2023,Real Sociedad,La Liga,Mikel Oyarzabal,ESP,"FW,MF",25,1997,13.5,13,7,5,3,5,5,19,26.3,14,14,4,10,3,16,5,0,https://fbref.com/en/players/8c3c640c/Mikel-Oyarzabal
2023,Real Sociedad,La Liga,Jon Pacheco,ESP,DF,21,2001,13.3,16,10,10,6,0,6,10,60,4,9,6,3,12,28,37,1,https://fbref.com/en/players/44150beb/Jon-Pacheco
2023,Real Sociedad,La Liga,Álex Remiro,ESP,GK,27,1995,38,1,1,1,0,0,1,3,33.3,2,0,0,0,0,1,17,3,https://fbref.com/en/players/374ee424/Alex-Remiro
2023,Real Sociedad,La Liga,Diego Rico,ESP,DF,29,1993,18.3,35,21,17,11,7,12,27,44.4,15,18,5,13,20,55,51,1,https://fbref.com/en/players/d9ba39fc/Diego-Rico
2023,Real Sociedad,La Liga,Umar Sadiq,NGA,FW,25,1997,0.9,1,1,0,0,1,0,1,0,1,2,0,2,0,1,0,0,https://fbref.com/en/players/686cbe7d/Umar-Sadiq
2023,Real Sociedad,La Liga,David Silva,ESP,MF,36,1986,21.5,36,21,11,18,7,11,19,57.9,8,17,2,15,15,51,16,0,https://fbref.com/en/players/e2716bd0/David-Silva
2023,Real Sociedad,La Liga,Alex Sola,ESP,DF,23,1999,3.9,18,9,14,3,1,7,10,70,3,7,2,5,7,25,10,0,https://fbref.com/en/players/5fa714d5/Alex-Sola
2023,Real Sociedad,La Liga,Alexander Sørloth,NOR,FW,26,1995,26.5,18,9,3,6,9,7,14,50,7,15,1,14,2,20,26,1,https://fbref.com/en/players/e92cd3f7/Alexander-Sorloth
2023,Real Sociedad,La Liga,Beñat Turrientes,ESP,"MF,FW",20,2002,1.2,3,3,3,0,0,1,5,20,4,2,0,2,0,3,3,0,https://fbref.com/en/players/068f4dec/Benat-Turrientes
2023,Real Sociedad,La Liga,Igor Zubeldia,ESP,DF,25,1997,28.2,35,18,28,7,0,25,35,71.4,10,23,17,6,21,56,93,0,https://fbref.com/en/players/5c7845f6/Igor-Zubeldia
2023,Real Sociedad,La Liga,Martín Zubimendi,ESP,MF,23,1999,34.5,59,33,23,30,6,24,45,53.3,21,44,17,27,37,96,55,4,https://fbref.com/en/players/3ee0dd59/Martin-Zubimendi
2023,Sevilla,La Liga,Marcos Acuña,ARG,DF,30,1991,21.2,57,36,34,17,6,30,42,71.4,12,16,5,11,23,80,36,0,https://fbref.com/en/players/81442ecb/Marcos-Acuna
2023,Sevilla,La Liga,Carlos Álvarez,ESP,MF,18,2003,0.1,1,1,0,1,0,0,0,NA,0,0,0,0,0,1,0,0,https://fbref.com/en/players/56bcaaa0/Carlos-Alvarez
2023,Sevilla,La Liga,Loïc Bade,FRA,DF,22,2000,16.1,27,20,23,3,1,17,30,56.7,13,21,13,8,23,50,77,0,https://fbref.com/en/players/114bbdee/Loic-Bade
2023,Sevilla,La Liga,Yassine Bounou,MAR,GK,31,1991,23.9,2,1,2,0,0,1,4,25,3,0,0,0,2,4,11,1,https://fbref.com/en/players/f6798fc3/Yassine-Bounou
2023,Sevilla,La Liga,Manu Bueno,ESP,MF,18,2004,1.7,7,4,3,3,1,5,8,62.5,3,0,0,0,0,7,2,0,https://fbref.com/en/players/c5642098/Manu-Bueno
2023,Sevilla,La Liga,Carmona,ESP,DF,20,2002,5.9,13,11,5,3,5,9,16,56.3,7,10,6,4,7,20,17,1,https://fbref.com/en/players/2dce876a/Carmona
2023,Sevilla,La Liga,Jesús Corona,MEX,FW,29,1993,1.2,1,0,1,0,0,0,1,0,1,0,0,0,1,2,1,0,https://fbref.com/en/players/fb938d24/Jesus-Corona
2023,Sevilla,La Liga,Thomas Delaney,DEN,MF,30,1991,3.4,4,2,0,4,0,3,5,60,2,3,2,1,4,8,3,0,https://fbref.com/en/players/fe641c1a/Thomas-Delaney
2023,Sevilla,La Liga,Marko Dmitrović,SRB,GK,30,1992,14.1,0,0,0,0,0,0,0,NA,0,0,0,0,0,0,6,0,https://fbref.com/en/players/ac295d9e/Marko-Dmitrovic
2023,Sevilla,La Liga,Kasper Dolberg,DEN,FW,24,1997,2.2,1,0,0,1,0,1,3,33.3,2,0,0,0,0,1,5,0,https://fbref.com/en/players/cc83b74d/Kasper-Dolberg
2023,Sevilla,La Liga,Youssef En-Nesyri,MAR,FW,25,1997,18.5,16,8,3,7,6,4,14,28.6,10,6,2,4,4,20,16,0,https://fbref.com/en/players/04e17fd5/Youssef-En-Nesyri
2023,Sevilla,La Liga,Fernando,BRA,"MF,DF",35,1987,17.5,34,23,14,17,3,18,30,60,12,21,10,11,24,58,29,0,https://fbref.com/en/players/41f32541/Fernando
2023,Sevilla,La Liga,Bryan Gil,ESP,"FW,DF",21,2001,10.2,22,11,11,7,4,10,23,43.5,13,10,0,10,8,30,10,0,https://fbref.com/en/players/7b5ab7f2/Bryan-Gil
2023,Sevilla,La Liga,Papu Gómez,ARG,"FW,MF",34,1988,11.8,6,4,3,3,0,2,10,20,8,8,1,7,4,10,5,0,https://fbref.com/en/players/6e4df551/Papu-Gomez
2023,Sevilla,La Liga,Nemanja Gudelj,SRB,"DF,MF",30,1991,30.9,43,33,22,18,3,20,33,60.6,13,39,29,10,34,77,102,1,https://fbref.com/en/players/0076ab7f/Nemanja-Gudelj
2023,Sevilla,La Liga,Pape Gueye,SEN,MF,23,1999,13,37,22,13,21,3,16,33,48.5,17,21,5,16,22,59,10,0,https://fbref.com/en/players/7155e3e1/Pape-Gueye
2023,Sevilla,La Liga,Isco,ESP,"MF,FW",30,1992,8.9,15,9,6,5,4,8,14,57.1,6,3,0,3,10,25,3,0,https://fbref.com/en/players/a0b4bb3e/Isco
2023,Sevilla,La Liga,Diego Iturralde,ESP,DF,19,2003,0.5,1,0,1,0,0,0,2,0,2,0,0,0,0,1,1,0,https://fbref.com/en/players/9d33c71a/Diego-Iturralde
2023,Sevilla,La Liga,Adnan Januzaj,BEL,FW,27,1995,0.5,0,0,0,0,0,0,1,0,1,0,0,0,1,1,0,0,https://fbref.com/en/players/4737cebe/Adnan-Januzaj
2023,Sevilla,La Liga,Joan Jordán,ESP,MF,28,1994,17.7,32,17,13,17,2,16,38,42.1,22,14,7,7,16,48,14,2,https://fbref.com/en/players/2a0c8ba4/Joan-Jordan
2023,Sevilla,La Liga,Érik Lamela,ARG,"FW,MF",30,1992,20.5,46,27,14,16,16,12,34,35.3,22,26,2,24,7,53,3,0,https://fbref.com/en/players/abe66106/Erik-Lamela
2023,Sevilla,La Liga,Marcão,BRA,DF,26,1996,4.2,2,2,1,1,0,1,1,100,0,3,3,0,6,8,14,0,https://fbref.com/en/players/133faa84/Marcao
2023,Sevilla,La Liga,Rafa Mir,ESP,FW,25,1997,14.4,8,2,2,4,2,2,5,40,3,5,1,4,4,12,11,0,https://fbref.com/en/players/bbf5c11b/Rafa-Mir
2023,Sevilla,La Liga,Gonzalo Montiel,ARG,DF,25,1997,16.9,26,15,12,14,0,15,29,51.7,14,25,7,18,19,45,38,0,https://fbref.com/en/players/374d5158/Gonzalo-Montiel
2023,Sevilla,La Liga,Jesús Navas,ESP,"DF,FW",36,1985,22,19,12,8,3,8,11,22,50,11,18,7,11,22,41,52,1,https://fbref.com/en/players/3f10bd22/Jesus-Navas
2023,Sevilla,La Liga,Tanguy Nianzou,FRA,DF,20,2002,15.2,20,15,10,9,1,8,11,72.7,3,8,5,3,16,36,44,3,https://fbref.com/en/players/5853ac44/Tanguy-Nianzou
2023,Sevilla,La Liga,Lucas Ocampos,ARG,"FW,MF",28,1994,12.9,22,14,9,9,4,8,31,25.8,23,17,2,15,8,30,5,0,https://fbref.com/en/players/a08b974a/Lucas-Ocampos
2023,Sevilla,La Liga,Pedro Ortiz,ESP,MF,21,2000,0,0,0,0,0,0,0,0,NA,0,0,0,0,0,0,0,0,https://fbref.com/en/players/f9358b61/Pedro-Ortiz
2023,Sevilla,La Liga,Ivan Rakitić,CRO,MF,34,1988,19.9,37,26,10,18,9,19,40,47.5,21,21,1,20,27,64,20,0,https://fbref.com/en/players/89f951b5/Ivan-Rakitic
2023,Sevilla,La Liga,Karim Rekik,NED,DF,27,1994,13.1,11,5,8,3,0,4,5,80,1,12,5,7,10,21,24,0,https://fbref.com/en/players/3376a776/Karim-Rekik
2023,Sevilla,La Liga,Iván Romero,ESP,MF,21,2001,0.1,0,0,0,0,0,0,0,NA,0,0,0,0,0,0,0,0,https://fbref.com/en/players/2fbe6af0/Ivan-Romero
2023,Sevilla,La Liga,Kike Salas,ESP,DF,20,2002,4.1,1,1,1,0,0,0,0,NA,0,4,3,1,5,6,23,0,https://fbref.com/en/players/0a69de7b/Kike-Salas
2023,Sevilla,La Liga,Suso,ESP,"MF,FW",28,1993,11.8,16,10,5,7,4,10,22,45.5,12,7,1,6,2,18,3,0,https://fbref.com/en/players/4e219ad2/Suso
2023,Sevilla,La Liga,Alex Telles,BRA,DF,29,1992,15.9,21,13,15,6,0,13,25,52,12,17,5,12,20,41,38,0,https://fbref.com/en/players/e73c9bb2/Alex-Telles
2023,Sevilla,La Liga,Óliver Torres,ESP,"MF,FW",27,1994,23.7,39,23,12,13,14,18,59,30.5,41,26,5,21,10,49,10,0,https://fbref.com/en/players/58a9a4d9/Oliver-Torres
2023,Valencia,La Liga,Domingos André Ribeiro Almeida,POR,MF,22,2000,28.2,66,42,23,32,11,26,57,45.6,31,26,0,26,20,86,16,1,https://fbref.com/en/players/e6697917/Domingos-Andre-Ribeiro-Almeida
2023,Valencia,La Liga,Marcos André,BRA,"FW,MF",25,1996,5,4,1,1,1,2,1,2,50,1,4,1,3,0,4,0,0,https://fbref.com/en/players/ae86d473/Marcos-Andre
2023,Valencia,La Liga,Samu Castillejo,ESP,"FW,MF",27,1995,15.1,21,12,8,9,4,8,40,20,32,21,2,19,9,30,2,0,https://fbref.com/en/players/130a7a3f/Samu-Castillejo
2023,Valencia,La Liga,Edinson Cavani,URU,FW,35,1987,16.1,7,4,3,3,1,3,15,20,12,10,3,7,2,9,11,0,https://fbref.com/en/players/527f063d/Edinson-Cavani
2023,Valencia,La Liga,Eray Cömert,SUI,DF,24,1998,18.6,35,23,24,10,1,17,33,51.5,16,23,8,15,29,64,76,1,https://fbref.com/en/players/15937e17/Eray-Comert
2023,Valencia,La Liga,Thierry Correia,POR,DF,23,1999,22.3,71,52,46,22,3,31,54,57.4,23,25,2,23,24,95,54,2,https://fbref.com/en/players/c78b352d/Thierry-Correia
2023,Valencia,La Liga,Mouctar Diakhaby,GUI,DF,25,1996,27.2,30,16,19,11,0,13,20,65,7,30,17,13,20,50,111,2,https://fbref.com/en/players/d2110326/Mouctar-Diakhaby
2023,Valencia,La Liga,Hugo Duro,ESP,FW,22,1999,15.4,15,12,2,6,7,7,17,41.2,10,11,1,10,2,17,7,1,https://fbref.com/en/players/37e103f8/Hugo-Duro
2023,Valencia,La Liga,Dimitri Foulquier,FRA,DF,29,1993,19.3,31,19,17,8,6,20,28,71.4,8,19,3,16,14,45,40,0,https://fbref.com/en/players/45e17712/Dimitri-Foulquier
2023,Valencia,La Liga,Maxi Gómez,URU,FW,25,1996,1.2,0,0,0,0,0,0,0,NA,0,0,0,0,0,0,2,0,https://fbref.com/en/players/4c2e9442/Maxi-Gomez
2023,Valencia,La Liga,Nicolás González,ESP,MF,20,2002,15.6,27,15,11,13,3,9,25,36,16,21,7,14,19,46,16,0,https://fbref.com/en/players/2c56a792/Nicolas-Gonzalez
2023,Valencia,La Liga,Javier Guerra,ESP,MF,19,2003,6.7,16,13,7,4,5,9,20,45,11,8,1,7,11,27,9,0,https://fbref.com/en/players/3828f130/Javier-Guerra
2023,Valencia,La Liga,Hugo Guillamón,ESP,MF,22,2000,18.1,20,12,10,8,2,8,24,33.3,16,14,2,12,19,39,30,2,https://fbref.com/en/players/f7c12fbf/Hugo-Guillamon
2023,Valencia,La Liga,Justin Kluivert,NED,"FW,MF",23,1999,16.1,17,14,7,4,6,6,12,50,6,4,0,4,7,24,4,0,https://fbref.com/en/players/4c3a6744/Justin-Kluivert
2023,Valencia,La Liga,Toni Lato,ESP,"DF,MF",24,1997,10.2,23,11,9,12,2,9,21,42.9,12,10,1,9,6,29,14,0,https://fbref.com/en/players/8e088e04/Toni-Lato
2023,Valencia,La Liga,Samuel Lino,BRA,"FW,MF",22,1999,32.1,66,43,17,37,12,26,72,36.1,46,34,0,34,18,84,16,0,https://fbref.com/en/players/2a295d33/Samuel-Lino
2023,Valencia,La Liga,Diego López,ESP,"FW,MF",20,2002,5,2,2,1,1,0,2,15,13.3,13,9,0,9,3,5,5,0,https://fbref.com/en/players/c487901c/Diego-Lopez
2023,Valencia,La Liga,José Luis Gayà,ESP,DF,27,1995,30.1,80,46,61,16,3,43,74,58.1,31,28,9,19,23,103,48,0,https://fbref.com/en/players/b05e2dbd/Jose-Luis-Gaya
2023,Valencia,La Liga,Giorgi Mamardashvili,GEO,GK,21,2000,38,0,0,0,0,0,0,0,NA,0,0,0,0,1,1,11,4,https://fbref.com/en/players/d4b73232/Giorgi-Mamardashvili
2023,Valencia,La Liga,Alberto Marí,ESP,"FW,MF",21,2001,1,0,0,0,0,0,0,2,0,2,0,0,0,0,0,1,0,https://fbref.com/en/players/44330c36/Alberto-Mari
2023,Valencia,La Liga,Ilaix Moriba,GUI,MF,19,2003,11.2,35,16,14,17,4,14,24,58.3,10,11,1,10,4,39,12,0,https://fbref.com/en/players/f4c69aa6/Ilaix-Moriba
2023,Valencia,La Liga,Cristhian Mosquera,ESP,DF,18,2004,1.6,4,2,3,1,0,4,5,80,1,1,0,1,1,5,5,0,https://fbref.com/en/players/dc1ce4f5/Cristhian-Mosquera
2023,Valencia,La Liga,Yunus Musah,USA,MF,19,2002,23.4,48,35,17,23,8,20,30,66.7,10,20,1,19,11,59,16,2,https://fbref.com/en/players/b51b1b9c/Yunus-Musah
2023,Valencia,La Liga,Cenk Özkacar,TUR,DF,21,2000,15.2,27,20,17,10,0,14,19,73.7,5,14,2,12,12,39,47,4,https://fbref.com/en/players/9a93efc9/Cenk-Ozkacar
2023,Valencia,La Liga,Gabriel Paulista,BRA,DF,31,1990,16.7,17,9,13,4,0,13,19,68.4,6,22,14,8,32,49,79,2,https://fbref.com/en/players/b7ca5c51/Gabriel-Paulista
2023,Valencia,La Liga,Francisco Perez,ESP,"FW,MF",19,2002,1.6,1,1,1,0,0,0,3,0,3,0,0,0,0,1,1,0,https://fbref.com/en/players/3d79a68c/Francisco-Perez
2023,Valencia,La Liga,Carlos Soler,ESP,MF,25,1997,2.7,2,0,0,1,1,2,3,66.7,1,1,0,1,0,2,2,0,https://fbref.com/en/players/fed17f5a/Carlos-Soler
2023,Valencia,La Liga,Jesus Vazquez,ESP,"DF,MF",19,2003,3.4,13,8,9,1,3,6,11,54.5,5,4,0,4,1,14,8,0,https://fbref.com/en/players/106c142c/Jesus-Vazquez
2023,Valladolid,La Liga,Álvaro Aceves,ESP,GK,19,2003,0.1,0,0,0,0,0,0,0,NA,0,0,0,0,0,0,0,0,https://fbref.com/en/players/be6faae0/Alvaro-Aceves
2023,Valladolid,La Liga,Álvaro Aguado,ESP,MF,26,1996,21,27,15,13,11,3,15,25,60,10,16,4,12,13,40,15,0,https://fbref.com/en/players/014aa7bd/Alvaro-Aguado
2023,Valladolid,La Liga,Babatunde Akinsola,NGA,FW,19,2003,0.1,1,1,0,0,1,0,0,NA,0,0,0,0,0,1,0,0,https://fbref.com/en/players/733aab44/Babatunde-Akinsola
2023,Valladolid,La Liga,Selim Amallah,MAR,"MF,FW",25,1996,3,15,9,7,8,0,5,8,62.5,3,2,0,2,5,20,2,0,https://fbref.com/en/players/00eba9c9/Selim-Amallah
2023,Valladolid,La Liga,Anuar,MAR,"MF,FW",27,1995,2.3,4,4,0,1,3,0,0,NA,0,5,2,3,3,7,3,0,https://fbref.com/en/players/c93231dc/Anuar
2023,Valladolid,La Liga,Roberto Arroyo,ESP,MF,18,2003,0.2,1,1,0,1,0,1,1,100,0,0,0,0,0,1,0,0,https://fbref.com/en/players/6091cf45/Roberto-Arroyo
2023,Valladolid,La Liga,Sergio Asenjo,ESP,GK,33,1989,10,0,0,0,0,0,0,0,NA,0,0,0,0,0,0,10,2,https://fbref.com/en/players/9f0ea33f/Sergio-Asenjo
2023,Valladolid,La Liga,Sergio Escudero,ESP,DF,32,1989,16,33,19,21,8,4,15,35,42.9,20,26,6,20,26,59,46,0,https://fbref.com/en/players/b0616e3d/Sergio-Escudero
2023,Valladolid,La Liga,Zouhair Feddal,MAR,DF,33,1989,4.2,4,2,1,3,0,3,4,75,1,9,9,0,5,9,27,0,https://fbref.com/en/players/89151b16/Zouhair-Feddal
2023,Valladolid,La Liga,Joaquín Fernández,ESP,DF,26,1996,24,35,28,20,11,4,19,30,63.3,11,31,22,9,27,62,98,1,https://fbref.com/en/players/b86a64b2/Joaquin-Fernandez
2023,Valladolid,La Liga,Iván Fresneda,ESP,DF,17,2004,19.4,48,34,31,13,4,29,47,61.7,18,32,8,24,15,63,60,0,https://fbref.com/en/players/29d0f2ac/Ivan-Fresneda
2023,Valladolid,La Liga,Sékou Gassama,SEN,FW,27,1995,0.4,0,0,0,0,0,0,0,NA,0,0,0,0,0,0,0,0,https://fbref.com/en/players/475a738b/Sekou-Gassama
2023,Valladolid,La Liga,Sergi Guardiola,ESP,FW,31,1991,5.6,12,7,6,5,1,2,4,50,2,6,0,6,2,14,7,0,https://fbref.com/en/players/32974271/Sergi-Guardiola
2023,Valladolid,La Liga,Martin Hongla,CMR,"DF,MF",24,1998,14.5,18,13,13,5,0,11,21,52.4,10,15,12,3,8,26,46,1,https://fbref.com/en/players/b85bf253/Martin-Hongla
2023,Valladolid,La Liga,Kenedy,BRA,"FW,DF",26,1996,3.1,6,2,3,3,0,2,4,50,2,2,0,2,1,7,0,0,https://fbref.com/en/players/5eebbfdf/Kenedy
2023,Valladolid,La Liga,Cyle Larin,CAN,FW,27,1995,16.3,9,3,2,4,3,3,7,42.9,4,6,3,3,0,9,15,0,https://fbref.com/en/players/e7af9060/Cyle-Larin
2023,Valladolid,La Liga,Sergio León,ESP,FW,33,1989,14.8,6,4,0,4,2,3,6,50,3,6,0,6,0,6,4,0,https://fbref.com/en/players/0a0cc13c/Sergio-Leon
2023,Valladolid,La Liga,Darwin Machís,VEN,FW,29,1993,6.7,3,2,0,2,1,1,8,12.5,7,5,0,5,3,6,4,0,https://fbref.com/en/players/ed6ea4d9/Darwin-Machis
2023,Valladolid,La Liga,Mickael Malsa,MTQ,MF,26,1995,0.8,2,2,1,1,0,1,4,25,3,1,1,0,2,4,3,0,https://fbref.com/en/players/bbc19252/Mickael-Malsa
2023,Valladolid,La Liga,Jordi Masip,ESP,GK,33,1989,27.9,0,0,0,0,0,0,2,0,2,0,0,0,1,1,3,2,https://fbref.com/en/players/8fae77ea/Jordi-Masip
2023,Valladolid,La Liga,Roque Mesa,ESP,MF,33,1989,18,27,15,16,10,1,12,38,31.6,26,16,4,12,13,40,18,0,https://fbref.com/en/players/7c4243d4/Roque-Mesa
2023,Valladolid,La Liga,Monchu,ESP,MF,22,1999,22.6,50,29,20,21,9,19,46,41.3,27,28,11,17,18,68,22,1,https://fbref.com/en/players/8ac501f5/Monchu
2023,Valladolid,La Liga,Juanjo Narváez,COL,"MF,FW",27,1995,1.6,1,1,1,0,0,1,1,100,0,2,0,2,0,1,0,0,https://fbref.com/en/players/485e4939/Juanjo-Narvaez
2023,Valladolid,La Liga,Lucas Olaza,URU,DF,28,1994,16.6,24,14,12,10,2,17,26,65.4,9,20,8,12,14,38,34,0,https://fbref.com/en/players/4cee5954/Lucas-Olaza
2023,Valladolid,La Liga,Lucas Oliveira Rosa,BRA,DF,22,2000,10.3,39,18,23,10,6,12,20,60,8,12,2,10,15,54,24,0,https://fbref.com/en/players/5132b92c/Lucas-Oliveira-Rosa
2023,Valladolid,La Liga,Kike Pérez,ESP,MF,25,1997,25.6,67,33,30,32,5,25,68,36.8,43,26,7,19,20,87,28,0,https://fbref.com/en/players/237a3851/Kike-Perez
2023,Valladolid,La Liga,Luis Pérez,ESP,DF,27,1995,13.5,44,24,26,12,6,27,38,71.1,11,13,4,9,16,60,29,0,https://fbref.com/en/players/b7c04927/Luis-Perez
2023,Valladolid,La Liga,Óscar Plano,ESP,"FW,MF",31,1991,22.6,40,25,9,17,14,12,37,32.4,25,26,2,24,29,69,23,0,https://fbref.com/en/players/7c388b20/Oscar-Plano
2023,Valladolid,La Liga,Gonzalo Plata,ECU,FW,21,2000,25.6,66,35,31,24,11,23,70,32.9,47,40,0,40,12,78,10,1,https://fbref.com/en/players/54bcdeb0/Gonzalo-Plata
2023,Valladolid,La Liga,Manuel Pozo,ESP,FW,20,2001,0.2,0,0,0,0,0,0,0,NA,0,2,0,2,2,2,0,0,https://fbref.com/en/players/35440884/Manuel-Pozo
2023,Valladolid,La Liga,Iván Sánchez,ESP,"MF,FW",29,1992,12.8,20,14,8,8,4,10,27,37,17,14,1,13,8,28,4,0,https://fbref.com/en/players/70107d4d/Ivan-Sanchez
2023,Valladolid,La Liga,Javi Sánchez,ESP,DF,25,1997,26.6,43,26,27,15,1,17,26,65.4,9,32,22,10,46,89,116,0,https://fbref.com/en/players/60359288/Javi-Sanchez
2023,Valladolid,La Liga,David Torres,ESP,DF,19,2003,4.3,1,1,0,1,0,1,1,100,0,4,2,2,3,4,8,0,https://fbref.com/en/players/381dbcfc/David-Torres
2023,Valladolid,La Liga,Toni Villa,ESP,MF,27,1995,1,6,3,2,3,1,4,9,44.4,5,0,0,0,0,6,0,0,https://fbref.com/en/players/636eae97/Toni-Villa
2023,Valladolid,La Liga,Shon Weissman,ISR,FW,26,1996,8.3,2,1,1,1,0,0,4,0,4,8,0,8,1,3,7,0,https://fbref.com/en/players/379dc075/Shon-Weissman
2023,Valladolid,La Liga,Jawad El Yamiq,MAR,DF,30,1992,17.9,17,11,10,7,0,6,11,54.5,5,27,19,8,37,54,101,0,https://fbref.com/en/players/f6f6b6e8/Jawad-El-Yamiq
2023,Villarreal,La Liga,Raúl Albiol,ESP,DF,36,1985,23.5,25,17,17,6,2,14,18,77.8,4,17,13,4,14,39,111,0,https://fbref.com/en/players/4bd414c1/Raul-Albiol
2023,Villarreal,La Liga,Alex Baena,ESP,"MF,FW",21,2001,21.6,30,17,9,15,6,15,45,33.3,30,15,3,12,7,37,16,0,https://fbref.com/en/players/518f2234/Alex-Baena
2023,Villarreal,La Liga,Étienne Capoue,FRA,MF,34,1988,21.7,21,12,6,13,2,10,18,55.6,8,12,5,7,19,40,20,1,https://fbref.com/en/players/5acc4a10/Etienne-Capoue
2023,Villarreal,La Liga,Samuel Chukwueze,NGA,"FW,MF",23,1999,26,14,7,7,2,5,7,23,30.4,16,13,0,13,12,26,16,0,https://fbref.com/en/players/b8a642fc/Samuel-Chukwueze
2023,Villarreal,La Liga,Diego Collado,ESP,FW,21,2001,0.1,0,0,0,0,0,0,0,NA,0,0,0,0,0,0,0,0,https://fbref.com/en/players/b3f62bfc/Diego-Collado
2023,Villarreal,La Liga,Francis Coquelin,FRA,MF,31,1991,8.3,18,13,7,9,2,7,7,100,0,8,2,6,9,27,7,0,https://fbref.com/en/players/a6951bf8/Francis-Coquelin
2023,Villarreal,La Liga,Jorge Cuenca,ESP,DF,22,1999,5.6,9,7,7,2,0,4,7,57.1,3,10,8,2,6,15,44,0,https://fbref.com/en/players/0abc51f2/Jorge-Cuenca
2023,Villarreal,La Liga,Arnaut Danjuma,NED,FW,25,1997,5.3,3,3,1,0,2,1,2,50,1,0,0,0,0,3,1,1,https://fbref.com/en/players/f08490a6/Arnaut-Danjuma
2023,Villarreal,La Liga,Alberto Del Moral,ESP,MF,22,2000,0.1,0,0,0,0,0,0,0,NA,0,0,0,0,0,0,0,0,https://fbref.com/en/players/84a85b48/Alberto-Del-Moral
2023,Villarreal,La Liga,Mamadou Fall,SEN,DF,19,2002,0.3,0,0,0,0,0,0,0,NA,0,1,0,1,0,0,1,0,https://fbref.com/en/players/805a2a11/Mamadou-Fall
2023,Villarreal,La Liga,Kiko Femenía,ESP,DF,31,1991,12.6,18,9,14,3,1,13,18,72.2,5,15,6,9,20,38,22,0,https://fbref.com/en/players/e5d01ecf/Kiko-Femenia
2023,Villarreal,La Liga,Juan Foyth,ARG,DF,24,1998,21.8,73,48,49,22,2,41,57,71.9,16,32,11,21,20,93,68,0,https://fbref.com/en/players/6c7762c3/Juan-Foyth
2023,Villarreal,La Liga,Haissem Hassan,FRA,"FW,MF",20,2002,0.6,0,0,0,0,0,0,2,0,2,0,0,0,1,1,0,0,https://fbref.com/en/players/e0979e74/Haissem-Hassan
2023,Villarreal,La Liga,Nicolas Jackson,SEN,FW,21,2001,17.8,14,11,2,10,2,2,8,25,6,18,2,16,2,16,4,0,https://fbref.com/en/players/9c36ed83/Nicolas-Jackson
2023,Villarreal,La Liga,Filip Jørgensen,DEN,GK,20,2002,2,0,0,0,0,0,0,1,0,1,0,0,0,0,0,0,0,https://fbref.com/en/players/0107757e/Filip-Jorgensen
2023,Villarreal,La Liga,Giovani Lo Celso,ARG,"MF,FW",26,1996,12.5,32,28,7,15,10,12,21,57.1,9,14,2,12,6,38,5,0,https://fbref.com/en/players/d7553721/Giovani-Lo-Celso
2023,Villarreal,La Liga,José Luis Morales,ESP,"FW,MF",35,1987,13.5,7,6,1,2,4,5,17,29.4,12,12,1,11,2,9,2,0,https://fbref.com/en/players/4a478107/Jose-Luis-Morales
2023,Villarreal,La Liga,Aïssa Mandi,ALG,DF,30,1991,16.2,18,10,14,3,1,6,12,50,6,19,14,5,21,39,58,0,https://fbref.com/en/players/fbd6378b/Aissa-Mandi
2023,Villarreal,La Liga,Johan Mojica,COL,DF,29,1992,7.1,13,9,9,3,1,5,9,55.6,4,8,3,5,4,17,14,1,https://fbref.com/en/players/608f2092/Johan-Mojica
2023,Villarreal,La Liga,Alberto Moreno,ESP,DF,30,1992,14.4,23,12,10,10,3,11,24,45.8,13,12,1,11,23,46,26,0,https://fbref.com/en/players/11b9265b/Alberto-Moreno
2023,Villarreal,La Liga,Gerard Moreno,ESP,FW,30,1992,13.7,11,6,0,6,5,3,6,50,3,6,2,4,5,16,10,0,https://fbref.com/en/players/81f0781e/Gerard-Moreno
2023,Villarreal,La Liga,Manu Morlanes,ESP,MF,23,1999,1.8,3,2,2,1,0,3,3,100,0,3,2,1,1,4,2,0,https://fbref.com/en/players/a0255c67/Manu-Morlanes
2023,Villarreal,La Liga,Fernando Niño,ESP,"MF,FW",21,2000,0.2,0,0,0,0,0,0,0,NA,0,0,0,0,0,0,0,0,https://fbref.com/en/players/81d5c497/Fernando-Nino
2023,Villarreal,La Liga,Daniel Parejo,ESP,MF,33,1989,36.5,71,40,32,23,16,30,75,40,45,40,12,28,29,100,31,2,https://fbref.com/en/players/7460ca0d/Daniel-Parejo
2023,Villarreal,La Liga,Pascu,ESP,"DF,FW",19,2003,0.1,0,0,0,0,0,0,0,NA,0,0,0,0,0,0,0,0,https://fbref.com/en/players/a2d9cf74/Pascu
2023,Villarreal,La Liga,Alfonso Pedraza,ESP,DF,26,1996,18.1,35,26,20,10,5,19,29,65.5,10,19,1,18,18,53,31,0,https://fbref.com/en/players/63f04c6c/Alfonso-Pedraza
2023,Villarreal,La Liga,Yeremi Pino,ESP,"FW,MF",19,2002,27.2,62,38,25,20,17,21,56,37.5,35,41,4,37,15,77,36,0,https://fbref.com/en/players/540ec57b/Yeremi-Pino
2023,Villarreal,La Liga,Pepe Reina,ESP,GK,39,1982,22,0,0,0,0,0,0,1,0,1,0,0,0,1,1,4,4,https://fbref.com/en/players/e358587b/Pepe-Reina
2023,Villarreal,La Liga,Gerónimo Rulli,ARG,GK,30,1992,14,0,0,0,0,0,0,0,NA,0,1,0,1,1,1,6,2,https://fbref.com/en/players/625c144a/Geronimo-Rulli
2023,Villarreal,La Liga,Ramón Terrats,ESP,MF,21,2000,9.1,15,10,3,8,4,9,17,52.9,8,11,4,7,8,23,6,2,https://fbref.com/en/players/f36016a5/Ramon-Terrats
2023,Villarreal,La Liga,Pau Torres,ESP,DF,25,1997,33.9,43,25,25,13,5,23,36,63.9,13,36,27,9,13,56,146,3,https://fbref.com/en/players/532e1e4f/Pau-Torres
2023,Villarreal,La Liga,Manu Trigueros,ESP,MF,30,1991,9.2,20,14,9,5,6,9,22,40.9,13,9,2,7,5,25,4,0,https://fbref.com/en/players/963829d0/Manu-Trigueros
2024,Alavés,La Liga,Abdel Abqar,MAR,DF,24,1999,25.7,35,19,28,5,2,21,35,60,14,31,26,5,23,58,115,0,https://fbref.com/en/players/2bc7f211/Abdel-Abqar
2024,Alavés,La Liga,Carlos Benavídez,URU,MF,25,1998,12.6,56,35,19,26,11,19,34,55.9,15,13,5,8,19,75,31,0,https://fbref.com/en/players/9fb45456/Carlos-Benavidez
2024,Alavés,La Liga,Antonio Blanco,ESP,MF,23,2000,27,61,36,29,27,5,31,86,36,55,25,2,23,35,96,30,0,https://fbref.com/en/players/506daeac/Antonio-Blanco
2024,Alavés,La Liga,Rubén Duarte,ESP,DF,27,1995,20.9,39,20,21,16,2,21,31,67.7,10,21,6,15,23,62,69,0,https://fbref.com/en/players/1fe0492d/Ruben-Duarte
2024,Alavés,La Liga,Andoni Gorosabel,ESP,DF,26,1996,31.7,62,42,40,17,5,38,75,50.7,37,24,8,16,28,90,69,0,https://fbref.com/en/players/6f5f82c0/Andoni-Gorosabel
2024,Alavés,La Liga,Ander Guevara,ESP,MF,26,1997,32.6,59,32,28,25,6,31,64,48.4,33,34,12,22,13,72,46,1,https://fbref.com/en/players/8e48dc61/Ander-Guevara
2024,Alavés,La Liga,Jon Guridi,ESP,MF,28,1995,29.8,42,24,10,27,5,12,45,26.7,33,23,3,20,22,64,22,0,https://fbref.com/en/players/4c0a6a48/Jon-Guridi
2024,Alavés,La Liga,Ianis Hagi,ROU,"MF,FW",24,1998,8.9,17,12,2,14,1,5,12,41.7,7,8,0,8,5,22,4,0,https://fbref.com/en/players/0127419a/Ianis-Hagi
2024,Alavés,La Liga,Jon Karrikaburu,ESP,"MF,FW",20,2002,0.2,0,0,0,0,0,0,0,NA,0,0,0,0,0,0,0,0,https://fbref.com/en/players/211589b8/Jon-Karrikaburu
2024,Alavés,La Liga,Kiké,ESP,"FW,MF",33,1989,15.8,8,4,2,3,3,4,9,44.4,5,16,5,11,1,9,12,0,https://fbref.com/en/players/e897d8ba/Kike
2024,Alavés,La Liga,Javi López,ESP,DF,21,2002,26.5,23,12,11,9,3,15,26,57.7,11,25,9,16,10,33,77,1,https://fbref.com/en/players/e9ada8cf/Javi-Lopez
2024,Alavés,La Liga,Rafa Marín,ESP,DF,21,2002,27.1,32,20,23,9,0,14,27,51.9,13,34,21,13,33,65,129,2,https://fbref.com/en/players/3239a8ed/Rafa-Marin
2024,Alavés,La Liga,Tomás Mendes,ESP,MF,18,2004,0.1,0,0,0,0,0,0,0,NA,0,0,0,0,0,0,0,0,https://fbref.com/en/players/45f771db/Tomas-Mendes
2024,Alavés,La Liga,Miguel,ESP,"FW,MF",23,1999,0.7,0,0,0,0,0,0,0,NA,0,2,0,2,0,0,0,0,https://fbref.com/en/players/6763373d/Miguel
2024,Alavés,La Liga,Samu Omorodion,ESP,FW,19,2004,21.3,6,3,1,4,1,0,4,0,4,11,2,9,1,7,14,0,https://fbref.com/en/players/dc44b03c/Samu-Omorodion
2024,Alavés,La Liga,Eneko Ortiz,ESP,DF,20,2003,0.2,0,0,0,0,0,0,0,NA,0,0,0,0,0,0,0,0,https://fbref.com/en/players/dc5ea86b/Eneko-Ortiz
2024,Alavés,La Liga,Jesús Owono,EQG,GK,22,2001,4,0,0,0,0,0,0,0,NA,0,0,0,0,0,0,3,0,https://fbref.com/en/players/d6e3d7fb/Jesus-Owono
2024,Alavés,La Liga,Joaquín Panichelli,ARG,"FW,MF",20,2002,2.5,3,3,1,1,1,1,2,50,1,1,0,1,1,4,4,0,https://fbref.com/en/players/ae14af56/Joaquin-Panichelli
2024,Alavés,La Liga,Victor Parada,ESP,"FW,MF",21,2002,0,1,1,0,1,0,1,1,100,0,0,0,0,0,1,0,0,https://fbref.com/en/players/8ca358c5/Victor-Parada
2024,Alavés,La Liga,Abderrahman Rebbach,ALG,"FW,MF",24,1998,8,9,5,4,2,3,5,15,33.3,10,10,1,9,3,12,7,0,https://fbref.com/en/players/9a796115/Abderrahman-Rebbach
2024,Alavés,La Liga,Luis Rioja,ESP,"FW,MF",29,1993,27.8,27,19,10,12,5,14,43,32.6,29,28,1,27,16,43,28,0,https://fbref.com/en/players/eb3dd471/Luis-Rioja
2024,Alavés,La Liga,Unai Ropero,ESP,MF,21,2001,0.1,0,0,0,0,0,0,0,NA,0,0,0,0,0,0,0,0,https://fbref.com/en/players/7868c973/Unai-Ropero
2024,Alavés,La Liga,Aleksandar Sedlar,SRB,DF,31,1991,10.5,14,10,10,4,0,10,16,62.5,6,8,4,4,13,27,43,0,https://fbref.com/en/players/a35134ae/Aleksandar-Sedlar
2024,Alavés,La Liga,Giuliano Simeone,ARG,FW,20,2002,7,7,5,2,3,2,5,17,29.4,12,10,0,10,5,12,3,0,https://fbref.com/en/players/a6536561/Giuliano-Simeone
2024,Alavés,La Liga,Antonio Sivera,ESP,GK,26,1996,34,0,0,0,0,0,0,1,0,1,0,0,0,0,0,17,1,https://fbref.com/en/players/9970da54/Antonio-Sivera
2024,Alavés,La Liga,Alex Sola,ESP,"FW,MF",24,1999,14,27,15,11,9,7,14,26,53.8,12,18,2,16,11,38,16,0,https://fbref.com/en/players/5fa714d5/Alex-Sola
2024,Alavés,La Liga,Mamadou Sylla,SEN,"FW,MF",29,1994,0.2,0,0,0,0,0,0,0,NA,0,1,1,0,0,0,1,0,https://fbref.com/en/players/e5ec95f8/Mamadou-Sylla
2024,Alavés,La Liga,Nahuel Tenaglia,ARG,DF,27,1996,12.7,29,19,22,4,3,16,28,57.1,12,14,8,6,12,41,59,0,https://fbref.com/en/players/66654daa/Nahuel-Tenaglia
2024,Alavés,La Liga,Carlos Vicente,ESP,FW,24,1999,12.4,16,6,7,7,2,10,25,40,15,4,0,4,4,20,9,0,https://fbref.com/en/players/90df343e/Carlos-Vicente
2024,Alavés,La Liga,Xeber,ESP,"FW,MF",26,1997,3.4,5,5,3,2,0,3,7,42.9,4,2,1,1,1,6,2,0,https://fbref.com/en/players/d2c8aacc/Xeber
2024,Almería,La Liga,Sergio Akieme,ESP,DF,25,1997,18.6,27,15,18,7,2,13,16,81.3,3,14,4,10,10,37,34,0,https://fbref.com/en/players/06efa9dc/Sergio-Akieme
2024,Almería,La Liga,Sergio Arribas,ESP,"MF,FW",21,2001,22.7,34,17,16,17,1,14,31,45.2,17,20,1,19,16,50,8,1,https://fbref.com/en/players/1e465e70/Sergio-Arribas
2024,Almería,La Liga,Iddrisu Baba,GHA,MF,27,1996,15.9,46,26,27,18,1,17,39,43.6,22,20,6,14,11,57,27,2,https://fbref.com/en/players/bfd381b3/Iddrisu-Baba
2024,Almería,La Liga,Srđan Babić,SRB,DF,27,1996,1,2,2,0,2,0,1,1,100,0,1,1,0,0,2,2,0,https://fbref.com/en/players/075fe5a3/Srdjan-Babic
2024,Almería,La Liga,Léo Baptistão,BRA,FW,30,1992,20.4,25,16,12,8,5,9,25,36,16,13,1,12,11,36,22,0,https://fbref.com/en/players/35f6db55/Leo-Baptistao
2024,Almería,La Liga,Álex Centelles,ESP,DF,25,1997,10.9,11,6,9,2,0,8,18,44.4,10,5,2,3,18,29,29,0,https://fbref.com/en/players/ae852b7d/Alex-Centelles
2024,Almería,La Liga,Chumi,ESP,DF,24,1999,27,34,22,22,12,0,16,26,61.5,10,38,23,15,14,48,107,3,https://fbref.com/en/players/2475cf9b/Chumi
2024,Almería,La Liga,Adri Embarba,ESP,"FW,MF",31,1992,27.5,55,37,29,15,11,26,53,49.1,27,37,1,36,15,70,12,0,https://fbref.com/en/players/db8f0eba/Adri-Embarba
2024,Almería,La Liga,Fernando,ESP,GK,33,1990,4,0,0,0,0,0,0,0,NA,0,1,0,1,0,0,2,0,https://fbref.com/en/players/dabb2827/Fernando
2024,Almería,La Liga,Rachad Fettal,MAR,FW,18,2005,0.2,1,1,1,0,0,0,0,NA,0,0,0,0,0,1,0,0,https://fbref.com/en/players/ae9a9b2d/Rachad-Fettal
2024,Almería,La Liga,Édgar González,ESP,"DF,MF",26,1997,28,45,21,22,20,3,25,49,51,24,48,28,20,38,83,130,3,https://fbref.com/en/players/49d028db/Edgar-Gonzalez
2024,Almería,La Liga,Luis Javier Suárez,COL,FW,25,1997,10.2,7,5,2,5,0,2,6,33.3,4,11,0,11,0,7,13,0,https://fbref.com/en/players/eeba07f8/Luis-Javier-Suarez
2024,Almería,La Liga,Kaiky,BRA,DF,19,2004,5.8,7,4,6,0,1,3,6,50,3,9,7,2,3,10,29,1,https://fbref.com/en/players/55634fb8/Kaiky
2024,Almería,La Liga,Ibrahima Koné,MLI,FW,24,1999,3.1,1,0,1,0,0,1,1,100,0,1,0,1,0,1,4,0,https://fbref.com/en/players/04bb2b06/Ibrahima-Kone
2024,Almería,La Liga,Bruno Langa,MOZ,DF,25,1997,9.1,17,12,10,5,2,6,14,42.9,8,11,4,7,4,21,33,2,https://fbref.com/en/players/72947847/Bruno-Langa
2024,Almería,La Liga,Lázaro,BRA,"FW,MF",21,2002,3.2,4,1,2,0,2,2,8,25,6,4,0,4,1,5,1,0,https://fbref.com/en/players/86ff856b/Lazaro
2024,Almería,La Liga,Dion Lopy,SEN,MF,21,2002,21.3,62,37,36,20,6,17,44,38.6,27,23,5,18,15,77,22,2,https://fbref.com/en/players/64c14d49/Dion-Lopy
2024,Almería,La Liga,Anthony Lozano,HON,FW,30,1993,8.6,7,5,2,5,0,4,7,57.1,3,6,1,5,2,9,12,0,https://fbref.com/en/players/38699c72/Anthony-Lozano
2024,Almería,La Liga,Diego Mariño,ESP,GK,33,1990,1,0,0,0,0,0,0,0,NA,0,0,0,0,0,0,1,0,https://fbref.com/en/players/d9235a45/Diego-Marino
2024,Almería,La Liga,Luís Maximiano,POR,GK,24,1999,33,0,0,0,0,0,0,1,0,1,0,0,0,0,0,19,2,https://fbref.com/en/players/3318286e/Luis-Maximiano
2024,Almería,La Liga,Gonzalo Melero,ESP,"MF,FW",29,1994,12.3,14,8,7,5,2,7,19,36.8,12,12,4,8,4,18,11,0,https://fbref.com/en/players/3902e91b/Gonzalo-Melero
2024,Almería,La Liga,Houboulang Mendes,GNB,DF,25,1998,4.4,16,13,11,5,0,8,16,50,8,4,2,2,1,17,17,1,https://fbref.com/en/players/1545cf15/Houboulang-Mendes
2024,Almería,La Liga,Marko Milovanović,SRB,"FW,MF",19,2003,3.4,4,4,1,3,0,2,4,50,2,2,0,2,0,4,5,0,https://fbref.com/en/players/1fda2b14/Marko-Milovanovic
2024,Almería,La Liga,César Montes,MEX,DF,26,1997,19.9,22,13,13,9,0,9,18,50,9,21,9,12,11,33,94,0,https://fbref.com/en/players/28e957d7/Cesar-Montes
2024,Almería,La Liga,Marcos Peña,ESP,MF,18,2005,4.9,19,14,12,7,0,6,12,50,6,9,3,6,13,32,8,0,https://fbref.com/en/players/736c14ec/Marcos-Pena
2024,Almería,La Liga,Alejandro Pozo Pozo,ESP,"DF,MF",24,1999,10.8,19,12,11,6,2,12,20,60,8,14,4,10,7,26,21,0,https://fbref.com/en/players/3c16d927/Alejandro-Pozo-Pozo
2024,Almería,La Liga,Marc Pubill,ESP,DF,20,2003,20.9,47,23,35,8,4,22,39,56.4,17,20,8,12,15,62,83,1,https://fbref.com/en/players/365113c0/Marc-Pubill
2024,Almería,La Liga,Arnau Puigmal,ESP,"FW,DF",22,2001,2.8,2,1,1,1,0,1,3,33.3,2,3,0,3,3,5,2,0,https://fbref.com/en/players/39352da2/Arnau-Puigmal
2024,Almería,La Liga,Aleksandar Radovanović,SRB,DF,29,1993,6.3,8,7,7,1,0,6,6,100,0,8,8,0,11,19,48,0,https://fbref.com/en/players/09507ffa/Aleksandar-Radovanovic
2024,Almería,La Liga,Largie Ramazani,BEL,"FW,MF",22,2001,17.3,12,7,5,6,1,6,26,23.1,20,16,2,14,34,46,10,0,https://fbref.com/en/players/cc9256ef/Largie-Ramazani
2024,Almería,La Liga,Lucas Robertone,ARG,MF,26,1997,26.5,61,33,28,23,10,25,50,50,25,43,9,34,51,112,43,0,https://fbref.com/en/players/a8981944/Lucas-Robertone
2024,Almería,La Liga,Luka Romero,ARG,FW,18,2004,4.9,5,1,2,3,0,2,4,50,2,12,1,11,1,6,2,1,https://fbref.com/en/players/ca6edaa0/Luka-Romero
2024,Almería,La Liga,Paco Sanz,ESP,DF,18,2004,0.3,0,0,0,0,0,0,1,0,1,0,0,0,0,0,4,0,https://fbref.com/en/players/b7aa8fd8/Paco-Sanz
2024,Almería,La Liga,Marciano Tchami,GNB,"FW,MF",19,2004,0.5,0,0,0,0,0,0,0,NA,0,0,0,0,0,0,0,0,https://fbref.com/en/players/19a5c0b6/Marciano-Tchami
2024,Almería,La Liga,Jonathan Viera,ESP,MF,33,1989,10.1,19,9,6,9,4,10,19,52.6,9,4,0,4,4,23,1,0,https://fbref.com/en/players/efa708aa/Jonathan-Viera
2024,Athletic Club,La Liga,Julen Agirrezabala,ESP,GK,22,2000,2.6,0,0,0,0,0,0,0,NA,0,0,0,0,0,0,0,0,https://fbref.com/en/players/a2c1a8d3/Julen-Agirrezabala
2024,Athletic Club,La Liga,Yeray Álvarez,ESP,DF,28,1995,12.8,18,9,15,3,0,12,19,63.2,7,8,5,3,11,29,34,1,https://fbref.com/en/players/3ecc11d8/Yeray-Alvarez
2024,Athletic Club,La Liga,Adu Ares,ESP,FW,21,2001,2.9,8,4,4,2,2,2,3,66.7,1,1,0,1,1,9,0,0,https://fbref.com/en/players/a461f098/Adu-Ares
2024,Athletic Club,La Liga,Yuri Berchiche,ESP,DF,33,1990,21.4,33,25,13,14,6,19,33,57.6,14,28,9,19,20,53,62,0,https://fbref.com/en/players/b6e50615/Yuri-Berchiche
2024,Athletic Club,La Liga,Álex Berenguer,ESP,FW,28,1995,17.7,23,14,9,9,5,7,24,29.2,17,23,0,23,5,28,13,0,https://fbref.com/en/players/dc1c2fce/Alex-Berenguer
2024,Athletic Club,La Liga,Iñigo Ruiz de Galarreta,ESP,MF,29,1993,23.2,49,31,15,26,8,24,49,49,25,18,5,13,12,61,17,0,https://fbref.com/en/players/91f7631f/Inigo-Ruiz-de-Galarreta
2024,Athletic Club,La Liga,Dani García,ESP,MF,33,1990,8.3,17,11,4,7,6,12,24,50,12,9,3,6,8,25,11,0,https://fbref.com/en/players/240d3a0b/Dani-Garcia
2024,Athletic Club,La Liga,Raúl García,ESP,"FW,MF",37,1986,4.7,9,6,2,4,3,4,9,44.4,5,10,1,9,3,12,9,0,https://fbref.com/en/players/b418dbd4/Raul-Garcia
2024,Athletic Club,La Liga,Unai Gómez,ESP,MF,20,2003,9.7,12,10,2,6,4,5,10,50,5,13,2,11,2,14,9,0,https://fbref.com/en/players/37db6cae/Unai-Gomez
2024,Athletic Club,La Liga,Gorka Guruzeta,ESP,FW,26,1996,24.6,34,23,6,25,3,9,30,30,21,36,2,34,17,51,23,0,https://fbref.com/en/players/6b5ea2f4/Gorka-Guruzeta
2024,Athletic Club,La Liga,Ander Herrera,ESP,MF,33,1989,11.4,44,32,11,26,7,20,36,55.6,16,16,6,10,15,59,18,1,https://fbref.com/en/players/436a9dd0/Ander-Herrera
2024,Athletic Club,La Liga,Imanol,ESP,DF,23,2000,5.8,7,5,1,5,1,5,18,27.8,13,6,0,6,7,14,15,0,https://fbref.com/en/players/9e095d72/Imanol
2024,Athletic Club,La Liga,Mikel Jauregizar,ESP,MF,19,2003,1.7,0,0,0,0,0,0,6,0,6,5,0,5,0,0,2,0,https://fbref.com/en/players/2f5c78ca/Mikel-Jauregizar
2024,Athletic Club,La Liga,Iñigo Lekue,ESP,DF,30,1993,22.2,40,22,25,10,5,27,53,50.9,26,24,6,18,15,55,50,0,https://fbref.com/en/players/59b7d823/Inigo-Lekue
2024,Athletic Club,La Liga,Óscar de Marcos,ESP,DF,34,1989,25.1,56,39,26,24,6,42,71,59.2,29,28,6,22,15,71,44,0,https://fbref.com/en/players/9f323c71/Oscar-de-Marcos
2024,Athletic Club,La Liga,Iker Muniain,ESP,"MF,FW",30,1992,6.6,5,1,2,3,0,1,3,33.3,2,4,1,3,0,5,0,0,https://fbref.com/en/players/c05dfb74/Iker-Muniain
2024,Athletic Club,La Liga,Peru Nolaskoain,ESP,"DF,MF",24,1998,0.1,1,1,1,0,0,1,1,100,0,0,0,0,0,1,1,0,https://fbref.com/en/players/857cb4f3/Peru-Nolaskoain
2024,Athletic Club,La Liga,Aingeru Olabarrieta,ESP,FW,17,2005,0.1,0,0,0,0,0,0,0,NA,0,0,0,0,0,0,0,0,https://fbref.com/en/players/b7e92b0e/Aingeru-Olabarrieta
2024,Athletic Club,La Liga,Aitor Paredes,ESP,DF,23,2000,30,20,11,11,9,0,7,14,50,7,23,11,12,33,53,104,0,https://fbref.com/en/players/b906757a/Aitor-Paredes
2024,Athletic Club,La Liga,Beñat Prados,ESP,"MF,DF",22,2001,16.1,45,28,11,23,11,23,42,54.8,19,32,5,27,23,68,27,0,https://fbref.com/en/players/1f60244a/Benat-Prados
2024,Athletic Club,La Liga,Oihan Sancet,ESP,MF,23,2000,21.9,19,11,3,10,6,8,21,38.1,13,5,1,4,10,29,5,0,https://fbref.com/en/players/bdb624a3/Oihan-Sancet
2024,Athletic Club,La Liga,Unai Simón,ESP,GK,26,1997,35.4,2,1,1,1,0,2,3,66.7,1,0,0,0,1,3,9,0,https://fbref.com/en/players/5dcf3e90/Unai-Simon
2024,Athletic Club,La Liga,Mikel Vesga,ESP,MF,30,1993,17,40,20,11,23,6,19,49,38.8,30,19,7,12,32,72,35,1,https://fbref.com/en/players/b0fce72c/Mikel-Vesga
2024,Athletic Club,La Liga,Asier Villalibre,ESP,FW,25,1997,5.7,2,1,0,0,2,2,2,100,0,2,1,1,0,2,6,0,https://fbref.com/en/players/57be54ec/Asier-Villalibre
2024,Athletic Club,La Liga,Daniel Vivian,ESP,DF,24,1999,32,42,28,29,11,2,28,45,62.2,17,49,25,24,31,73,104,0,https://fbref.com/en/players/ab7bf91d/Daniel-Vivian
2024,Athletic Club,La Liga,Iñaki Williams,GHA,FW,29,1994,31.6,24,17,6,8,10,13,34,38.2,21,42,8,34,14,38,29,0,https://fbref.com/en/players/6a99e0b1/Inaki-Williams
2024,Athletic Club,La Liga,Nico Williams,ESP,FW,21,2002,25.1,31,12,9,15,7,13,36,36.1,23,18,2,16,3,34,4,1,https://fbref.com/en/players/afdc14d7/Nico-Williams
2024,Atlético Madrid,La Liga,César Azpilicueta,ESP,DF,33,1989,15.8,25,14,15,9,1,12,19,63.2,7,25,6,19,16,41,46,0,https://fbref.com/en/players/53cad200/Cesar-Azpilicueta
2024,Atlético Madrid,La Liga,Pablo Barrios,ESP,MF,20,2003,17.3,45,25,15,29,1,19,40,47.5,21,20,3,17,28,73,24,2,https://fbref.com/en/players/45736cec/Pablo-Barrios
2024,Atlético Madrid,La Liga,Yannick Carrasco,BEL,DF,29,1993,2.5,4,4,3,1,0,2,7,28.6,5,2,0,2,1,5,6,0,https://fbref.com/en/players/de39485a/Yannick-Carrasco
2024,Atlético Madrid,La Liga,Ángel Correa,ARG,"FW,MF",28,1995,17,22,15,3,11,8,5,17,29.4,12,13,0,13,2,24,6,0,https://fbref.com/en/players/01eb744d/Angel-Correa
2024,Atlético Madrid,La Liga,Rodrigo De Paul,ARG,MF,29,1994,23.1,31,21,11,14,6,15,38,39.5,23,28,1,27,11,42,15,2,https://fbref.com/en/players/162efffd/Rodrigo-De-Paul
2024,Atlético Madrid,La Liga,Javi Galán,ESP,DF,28,1994,1,5,4,2,2,1,4,5,80,1,1,0,1,1,6,3,0,https://fbref.com/en/players/a4b00319/Javi-Galan
2024,Atlético Madrid,La Liga,Antoine Griezmann,FRA,"FW,MF",32,1991,29.4,33,19,14,14,5,15,41,36.6,26,34,3,31,10,43,23,1,https://fbref.com/en/players/df69b544/Antoine-Griezmann
2024,Atlético Madrid,La Liga,Mario Hermoso,ESP,DF,28,1995,28.4,46,25,29,13,4,28,51,54.9,23,27,9,18,30,76,93,0,https://fbref.com/en/players/555f3a0b/Mario-Hermoso
2024,Atlético Madrid,La Liga,Salim El Jebari,MAR,MF,19,2004,0.1,1,0,0,1,0,0,0,NA,0,0,0,0,0,1,1,0,https://fbref.com/en/players/d068118b/Salim-El-Jebari
2024,Atlético Madrid,La Liga,Koke,ESP,MF,31,1992,27.7,66,44,27,32,7,36,79,45.6,43,37,12,25,16,82,34,1,https://fbref.com/en/players/55126f3b/Koke
2024,Atlético Madrid,La Liga,Thomas Lemar,FRA,MF,27,1995,1.8,3,1,2,1,0,1,2,50,1,0,0,0,0,3,0,0,https://fbref.com/en/players/4dbd0916/Thomas-Lemar
2024,Atlético Madrid,La Liga,Samuel Lino,BRA,"DF,MF",23,1999,23.1,61,34,32,17,12,35,70,50,35,37,1,36,14,75,27,0,https://fbref.com/en/players/2a295d33/Samuel-Lino
2024,Atlético Madrid,La Liga,Marcos Llorente,ESP,"MF,DF",28,1995,28.5,40,23,18,17,5,16,44,36.4,28,36,11,25,14,54,35,0,https://fbref.com/en/players/02c15616/Marcos-Llorente
2024,Atlético Madrid,La Liga,Reinildo Mandava,MOZ,DF,29,1994,8.1,30,22,16,11,3,19,22,86.4,3,10,2,8,15,45,21,0,https://fbref.com/en/players/c20bdcd7/Reinildo-Mandava
2024,Atlético Madrid,La Liga,José María Giménez,URU,DF,28,1995,14.7,18,10,10,7,1,5,16,31.3,11,16,12,4,10,28,95,0,https://fbref.com/en/players/f0da930c/Jose-Maria-Gimenez
2024,Atlético Madrid,La Liga,Memphis,NED,FW,29,1994,9.9,5,2,0,3,2,3,6,50,3,2,0,2,1,6,0,0,https://fbref.com/en/players/8f696594/Memphis
2024,Atlético Madrid,La Liga,Nahuel Molina,ARG,DF,25,1998,20.6,38,22,16,18,4,26,54,48.1,28,19,3,16,9,47,36,1,https://fbref.com/en/players/23610943/Nahuel-Molina
2024,Atlético Madrid,La Liga,Álvaro Morata,ESP,FW,30,1992,21.2,16,10,4,7,5,3,5,60,2,18,3,15,1,17,26,0,https://fbref.com/en/players/129af0db/Alvaro-Morata
2024,Atlético Madrid,La Liga,Saúl Ñíguez,ESP,MF,28,1994,15.3,64,39,29,29,6,30,49,61.2,19,36,9,27,14,78,56,0,https://fbref.com/en/players/c14bc029/Saul-Niguez
2024,Atlético Madrid,La Liga,Jan Oblak,SVN,GK,30,1993,38,0,0,0,0,0,0,0,NA,0,0,0,0,0,0,10,0,https://fbref.com/en/players/ee8508c0/Jan-Oblak
2024,Atlético Madrid,La Liga,Gabriel Paulista,BRA,DF,32,1990,4.5,7,5,4,3,0,3,4,75,1,5,3,2,4,11,27,0,https://fbref.com/en/players/b7ca5c51/Gabriel-Paulista
2024,Atlético Madrid,La Liga,Abdellah Raihani,MAR,FW,19,2004,0.1,0,0,0,0,0,0,1,0,1,0,0,0,0,0,0,0,https://fbref.com/en/players/16ec501b/Abdellah-Raihani
2024,Atlético Madrid,La Liga,Rodrigo Riquelme,ESP,"DF,MF",23,2000,17,30,19,18,4,8,18,46,39.1,28,19,0,19,9,39,20,0,https://fbref.com/en/players/65154df0/Rodrigo-Riquelme
2024,Atlético Madrid,La Liga,Stefan Savić,MNE,DF,32,1991,18.1,27,19,16,7,4,15,30,50,15,29,15,14,27,54,61,1,https://fbref.com/en/players/f6ac68c1/Stefan-Savic
2024,Atlético Madrid,La Liga,Çağlar Söyüncü,TUR,DF,27,1996,1.3,1,1,1,0,0,0,0,NA,0,1,0,1,1,2,7,0,https://fbref.com/en/players/21166ff4/Caglar-Soyuncu
2024,Atlético Madrid,La Liga,Arthur Vermeeren,BEL,MF,18,2005,1.8,1,0,0,1,0,0,1,0,1,5,0,5,6,7,2,0,https://fbref.com/en/players/722494dc/Arthur-Vermeeren
2024,Atlético Madrid,La Liga,Axel Witsel,BEL,DF,34,1989,30.9,35,21,23,12,0,17,24,70.8,7,40,21,19,16,51,119,0,https://fbref.com/en/players/5dfc6ad5/Axel-Witsel
2024,Barcelona,La Liga,Marcos Alonso,ESP,DF,32,1990,2.8,5,3,2,3,0,3,4,75,1,2,0,2,4,9,6,0,https://fbref.com/en/players/f4290206/Marcos-Alonso
2024,Barcelona,La Liga,Ronald Araújo,URU,DF,24,1999,22.2,27,22,11,15,1,12,17,70.6,5,20,11,9,12,39,66,2,https://fbref.com/en/players/2bef2bca/Ronald-Araujo
2024,Barcelona,La Liga,Alejandro Balde,ESP,DF,19,2003,15.3,20,11,11,6,3,7,11,63.6,4,14,1,13,5,25,21,1,https://fbref.com/en/players/5ccc9672/Alejandro-Balde
2024,Barcelona,La Liga,João Cancelo,POR,DF,29,1994,27.8,64,44,35,21,8,38,58,65.5,20,35,6,29,29,93,59,1,https://fbref.com/en/players/bd6351cd/Joao-Cancelo
2024,Barcelona,La Liga,Marc Casado,ESP,MF,19,2003,0.2,1,1,1,0,0,1,1,100,0,0,0,0,1,2,2,0,https://fbref.com/en/players/2ef08833/Marc-Casado
2024,Barcelona,La Liga,Andreas Christensen,DEN,"DF,MF",27,1996,22,23,14,7,14,2,16,28,57.1,12,23,10,13,21,44,41,0,https://fbref.com/en/players/1cb49278/Andreas-Christensen
2024,Barcelona,La Liga,Pau Cubarsí,ESP,DF,16,2007,17.3,22,14,18,3,1,13,18,72.2,5,20,16,4,12,34,65,0,https://fbref.com/en/players/cc7888f3/Pau-Cubarsi
2024,Barcelona,La Liga,Abde Ezzalzouli,MAR,"FW,MF",21,2001,0.8,1,1,0,0,1,0,1,0,1,1,0,1,0,1,0,0,https://fbref.com/en/players/bed68338/Abde-Ezzalzouli
2024,Barcelona,La Liga,Ansu Fati,ESP,"MF,FW",20,2002,0.6,0,0,0,0,0,0,1,0,1,0,0,0,0,0,0,0,https://fbref.com/en/players/0ba976e4/Ansu-Fati
2024,Barcelona,La Liga,João Félix,POR,FW,23,1999,17.1,22,16,9,7,6,8,22,36.4,14,14,1,13,10,32,11,0,https://fbref.com/en/players/8aafd64f/Joao-Felix
2024,Barcelona,La Liga,Héctor Fort,ESP,DF,16,2006,3.5,6,5,5,1,0,4,10,40,6,0,0,0,2,8,4,0,https://fbref.com/en/players/2e31f3a6/Hector-Fort
2024,Barcelona,La Liga,Eric García,ESP,DF,22,2001,0.6,0,0,0,0,0,0,0,NA,0,1,1,0,0,0,0,0,https://fbref.com/en/players/2bed3eab/Eric-Garcia
2024,Barcelona,La Liga,Gavi,ESP,"MF,FW",18,2004,10.5,39,21,20,14,5,18,36,50,18,19,3,16,8,47,16,1,https://fbref.com/en/players/19cae58d/Gavi
2024,Barcelona,La Liga,Marc Guiu,ESP,"FW,MF",17,2006,0.8,1,0,0,1,0,0,0,NA,0,0,0,0,0,1,0,0,https://fbref.com/en/players/d3d774cc/Marc-Guiu
2024,Barcelona,La Liga,İlkay Gündoğan,GER,MF,32,1990,33.3,32,22,14,16,2,12,39,30.8,27,19,4,15,21,53,18,1,https://fbref.com/en/players/819b3158/Ilkay-Gundogan
2024,Barcelona,La Liga,Frenkie de Jong,NED,MF,26,1997,18.2,43,26,14,23,6,8,19,42.1,11,18,8,10,14,57,28,1,https://fbref.com/en/players/1bacc518/Frenkie-de-Jong
2024,Barcelona,La Liga,Jules Koundé,FRA,DF,24,1998,32.2,37,23,22,10,5,28,51,54.9,23,32,12,20,25,62,83,5,https://fbref.com/en/players/4d1666ff/Jules-Kounde
2024,Barcelona,La Liga,Robert Lewandowski,POL,FW,34,1988,30.6,8,5,0,6,2,4,12,33.3,8,13,4,9,9,17,18,0,https://fbref.com/en/players/8d78e732/Robert-Lewandowski
2024,Barcelona,La Liga,Fermin López,ESP,"MF,FW",20,2003,16.1,41,21,15,18,8,14,40,35,26,14,1,13,4,45,9,0,https://fbref.com/en/players/c1fe5f0b/Fermin-Lopez
2024,Barcelona,La Liga,Iñigo Martínez,ESP,DF,32,1991,14.4,10,7,9,1,0,6,8,75,2,13,10,3,11,21,50,0,https://fbref.com/en/players/3fc45c73/Inigo-Martinez
2024,Barcelona,La Liga,Pedri,ESP,"MF,FW",20,2002,16.4,33,24,16,13,4,8,27,29.6,19,27,3,24,14,47,10,0,https://fbref.com/en/players/0d9b2d31/Pedri
2024,Barcelona,La Liga,Iñaki Peña,ESP,GK,24,1999,10,0,0,0,0,0,0,1,0,1,0,0,0,0,0,5,1,https://fbref.com/en/players/cc1c5035/Inaki-Pena
2024,Barcelona,La Liga,Raphinha,BRA,"FW,MF",26,1996,15.2,14,8,6,6,2,4,18,22.2,14,17,1,16,13,27,11,0,https://fbref.com/en/players/3423f250/Raphinha
2024,Barcelona,La Liga,Sergi Roberto,ESP,"MF,DF",31,1992,9.6,15,10,4,10,1,3,11,27.3,8,7,2,5,8,23,7,1,https://fbref.com/en/players/335fa267/Sergi-Roberto
2024,Barcelona,La Liga,Oriol Romeu,ESP,MF,31,1991,10.4,34,20,17,14,3,13,24,54.2,11,12,2,10,10,44,18,0,https://fbref.com/en/players/4b511457/Oriol-Romeu
2024,Barcelona,La Liga,Vitor Roque,BRA,FW,18,2005,3.6,3,2,2,0,1,0,2,0,2,3,0,3,0,3,5,0,https://fbref.com/en/players/cb00f1e6/Vitor-Roque
2024,Barcelona,La Liga,Marc-André ter Stegen,GER,GK,31,1992,28,0,0,0,0,0,0,0,NA,0,0,0,0,0,0,3,3,https://fbref.com/en/players/6f51e382/Marc-Andre-ter-Stegen
2024,Barcelona,La Liga,Ferrán Torres,ESP,FW,23,2000,13.5,9,6,1,6,2,5,16,31.3,11,7,1,6,5,14,6,0,https://fbref.com/en/players/9e1035f8/Ferran-Torres
2024,Barcelona,La Liga,Lamine Yamal,ESP,FW,16,2007,24.5,61,37,32,15,14,18,48,37.5,30,32,0,32,19,80,11,0,https://fbref.com/en/players/82ec26c1/Lamine-Yamal
2024,Betis,La Liga,Abner,BRA,DF,23,2000,15.6,25,19,15,9,1,17,34,50,17,23,5,18,15,40,62,0,https://fbref.com/en/players/7f9c5d2d/Abner
2024,Betis,La Liga,Paul Akouokou,CIV,MF,25,1997,0.3,5,3,0,2,3,3,3,100,0,3,1,2,1,6,1,0,https://fbref.com/en/players/31f5b89b/Paul-Akouokou
2024,Betis,La Liga,Sergi Altimira,ESP,MF,21,2001,6.3,15,8,8,6,1,11,23,47.8,12,12,1,11,9,24,10,0,https://fbref.com/en/players/94acdd4e/Sergi-Altimira
2024,Betis,La Liga,Ezequiel Ávila,ARG,FW,29,1994,3.3,2,1,0,2,0,1,3,33.3,2,2,0,2,1,3,4,0,https://fbref.com/en/players/253a06b9/Ezequiel-Avila
2024,Betis,La Liga,Cédric Bakambu,COD,FW,32,1991,2.2,1,0,0,1,0,0,0,NA,0,2,0,2,0,1,0,0,https://fbref.com/en/players/0af4dcf0/Cedric-Bakambu
2024,Betis,La Liga,Marc Bartra,ESP,DF,32,1991,2.5,4,3,3,1,0,4,5,80,1,3,1,2,3,7,10,0,https://fbref.com/en/players/b742cc0d/Marc-Bartra
2024,Betis,La Liga,Héctor Bellerín,ESP,DF,28,1995,19,34,22,14,16,4,20,53,37.7,33,13,5,8,22,56,40,1,https://fbref.com/en/players/f874dd44/Hector-Bellerin
2024,Betis,La Liga,Claudio Bravo,CHI,GK,40,1983,7,0,0,0,0,0,0,1,0,1,0,0,0,0,0,2,0,https://fbref.com/en/players/10072610/Claudio-Bravo
2024,Betis,La Liga,Pablo Busto,ESP,DF,17,2005,0.5,1,1,0,0,1,1,1,100,0,0,0,0,1,2,3,0,https://fbref.com/en/players/da82ccb1/Pablo-Busto
2024,Betis,La Liga,Johnny Cardoso,USA,MF,21,2001,14.8,48,29,19,24,5,22,33,66.7,11,20,5,15,32,80,31,0,https://fbref.com/en/players/7426f085/Johnny-Cardoso
2024,Betis,La Liga,William Carvalho,POR,MF,31,1992,7.6,20,12,11,7,2,10,16,62.5,6,8,1,7,8,28,9,1,https://fbref.com/en/players/dee86451/William-Carvalho
2024,Betis,La Liga,Juan Cruz,ESP,FW,23,2000,0.8,0,0,0,0,0,0,1,0,1,0,0,0,0,0,0,0,https://fbref.com/en/players/cc2dd8a5/Juan-Cruz
2024,Betis,La Liga,Assane Diao,ESP,FW,17,2005,11.6,20,12,5,9,6,6,17,35.3,11,22,4,18,7,27,7,0,https://fbref.com/en/players/8ae7d0ec/Assane-Diao
2024,Betis,La Liga,Abde Ezzalzouli,MAR,FW,21,2001,9.6,17,14,7,5,5,4,14,28.6,10,10,0,10,5,22,5,0,https://fbref.com/en/players/bed68338/Abde-Ezzalzouli
2024,Betis,La Liga,Nabil Fekir,FRA,"MF,FW",30,1993,11.7,15,10,5,7,3,5,10,50,5,9,0,9,7,22,3,0,https://fbref.com/en/players/bece776f/Nabil-Fekir
2024,Betis,La Liga,Luiz Felipe,ITA,DF,26,1997,4,7,3,5,2,0,4,5,80,1,10,4,6,4,11,16,0,https://fbref.com/en/players/15d0c248/Luiz-Felipe
2024,Betis,La Liga,Pablo Fornals,ESP,"FW,MF",27,1996,12.8,24,16,8,11,5,12,22,54.5,10,14,0,14,22,46,10,2,https://fbref.com/en/players/82927de4/Pablo-Fornals
2024,Betis,La Liga,Andrés Guardado,MEX,MF,36,1986,5,17,12,5,9,3,7,14,50,7,4,2,2,6,23,5,0,https://fbref.com/en/players/ef322658/Andres-Guardado
2024,Betis,La Liga,Luiz Henrique,BRA,FW,22,2001,6.8,15,11,4,10,1,9,14,64.3,5,11,0,11,5,20,8,0,https://fbref.com/en/players/8059806f/Luiz-Henrique
2024,Betis,La Liga,Borja Iglesias,ESP,FW,30,1993,4.5,0,0,0,0,0,0,3,0,3,0,0,0,2,2,2,0,https://fbref.com/en/players/75645f0e/Borja-Iglesias
2024,Betis,La Liga,Isco,ESP,MF,31,1992,25.8,41,27,15,21,5,14,38,36.8,24,19,1,18,10,51,7,0,https://fbref.com/en/players/a0b4bb3e/Isco
2024,Betis,La Liga,Willian José,BRA,FW,31,1991,21.9,7,3,1,2,4,2,5,40,3,8,2,6,2,9,15,0,https://fbref.com/en/players/d87e2cae/Willian-Jose
2024,Betis,La Liga,Juan Miranda,ESP,DF,23,2000,20.6,38,24,21,13,4,17,31,54.8,14,31,6,25,19,57,62,0,https://fbref.com/en/players/ead61f73/Juan-Miranda
2024,Betis,La Liga,Sokratis Papastathopoulos,GRE,DF,35,1988,12.6,21,14,16,5,0,13,17,76.5,4,15,9,6,6,27,60,0,https://fbref.com/en/players/b682dcf6/Sokratis-Papastathopoulos
2024,Betis,La Liga,Ayoze Pérez,ESP,FW,30,1993,25.5,59,32,16,33,10,21,49,42.9,28,42,4,38,22,81,18,0,https://fbref.com/en/players/819aa8e7/Ayoze-Perez
2024,Betis,La Liga,Germán Pezzella,ARG,DF,32,1991,30.7,34,24,24,10,0,23,38,60.5,15,31,18,13,31,65,150,0,https://fbref.com/en/players/8c725b43/German-Pezzella
2024,Betis,La Liga,Chadi Riad,MAR,DF,20,2003,24,35,24,17,18,0,17,27,63,10,23,14,9,23,58,108,0,https://fbref.com/en/players/b3b9b8b8/Chadi-Riad
2024,Betis,La Liga,Marc Roca,ESP,MF,26,1996,22,52,36,17,29,6,30,53,56.6,23,29,6,23,17,69,23,1,https://fbref.com/en/players/da27e268/Marc-Roca
2024,Betis,La Liga,Rodri,ESP,"FW,MF",23,2000,11.7,17,10,6,7,4,8,21,38.1,13,11,0,11,8,25,2,0,https://fbref.com/en/players/85bed4ee/Rodri
2024,Betis,La Liga,Guido Rodríguez,ARG,MF,29,1994,20.5,53,30,21,24,8,34,55,61.8,21,27,6,21,29,82,44,0,https://fbref.com/en/players/34e393f2/Guido-Rodriguez
2024,Betis,La Liga,Aitor Ruibal,ESP,"DF,FW",27,1996,11.3,46,27,28,13,5,32,59,54.2,27,12,1,11,14,60,33,1,https://fbref.com/en/players/a55d8df5/Aitor-Ruibal
2024,Betis,La Liga,Youssouf Sabaly,SEN,DF,30,1993,11.6,16,11,12,3,1,8,12,66.7,4,6,3,3,11,27,27,0,https://fbref.com/en/players/fbbb9269/Youssouf-Sabaly
2024,Betis,La Liga,Rui Silva,POR,GK,29,1994,27.5,0,0,0,0,0,0,3,0,3,0,0,0,1,1,13,1,https://fbref.com/en/players/ea83bfa6/Rui-Silva
2024,Betis,La Liga,Fran Vieites,ESP,GK,24,1999,3.5,1,0,1,0,0,1,1,100,0,0,0,0,0,1,2,1,https://fbref.com/en/players/2ae958ab/Fran-Vieites
2024,Betis,La Liga,Ricardo Visus,ESP,DF,22,2001,1.8,2,2,1,1,0,2,2,100,0,2,2,0,2,4,9,1,https://fbref.com/en/players/7016332f/Ricardo-Visus
2024,Celta Vigo,La Liga,Joseph Aidoo,GHA,DF,27,1995,4.5,8,3,6,2,0,4,8,50,4,3,1,2,4,12,28,0,https://fbref.com/en/players/18abe173/Joseph-Aidoo
2024,Celta Vigo,La Liga,Tadeo Allende,ARG,"MF,FW",24,1999,3.7,6,1,3,2,1,4,6,66.7,2,3,0,3,3,9,3,0,https://fbref.com/en/players/75a66bed/Tadeo-Allende
2024,Celta Vigo,La Liga,Hugo Álvarez,ESP,"MF,DF",20,2003,8.5,14,9,8,3,3,9,20,45,11,4,1,3,5,19,9,0,https://fbref.com/en/players/6f392eb8/Hugo-Alvarez
2024,Celta Vigo,La Liga,Iago Aspas,ESP,FW,35,1987,30.1,11,6,4,6,1,1,15,6.7,14,23,3,20,10,21,8,0,https://fbref.com/en/players/7dcf86f6/Iago-Aspas
2024,Celta Vigo,La Liga,Jonathan Bamba,CIV,"MF,FW",27,1996,22,14,9,4,8,2,2,17,11.8,15,20,0,20,18,32,12,0,https://fbref.com/en/players/b2bd0f6c/Jonathan-Bamba
2024,Celta Vigo,La Liga,Fran Beltrán,ESP,MF,24,1999,27,56,32,22,23,11,24,63,38.1,39,28,2,26,18,74,34,0,https://fbref.com/en/players/ed5c5fa3/Fran-Beltran
2024,Celta Vigo,La Liga,Franco Cervi,ARG,"MF,DF",29,1994,6.1,24,18,13,9,2,13,24,54.2,11,16,0,16,9,33,4,0,https://fbref.com/en/players/5e1028e5/Franco-Cervi
2024,Celta Vigo,La Liga,Carlos Dominguez,ESP,DF,22,2001,17.6,33,21,17,9,7,23,37,62.2,14,24,12,12,22,55,78,0,https://fbref.com/en/players/3521abfe/Carlos-Dominguez
2024,Celta Vigo,La Liga,Carlos Dotor,ESP,MF,22,2001,7.9,14,7,3,8,3,4,13,30.8,9,12,2,10,4,18,4,0,https://fbref.com/en/players/daa2eab3/Carlos-Dotor
2024,Celta Vigo,La Liga,Anastasios Douvikas,GRE,FW,23,1999,10.1,15,7,2,6,7,3,8,37.5,5,6,3,3,2,17,9,0,https://fbref.com/en/players/853ca71c/Anastasios-Douvikas
2024,Celta Vigo,La Liga,Vicente Guaita,ESP,GK,36,1987,26.7,1,1,1,0,0,1,2,50,1,0,0,0,0,1,9,1,https://fbref.com/en/players/ab13a5aa/Vicente-Guaita
2024,Celta Vigo,La Liga,Luca de la Torre,USA,MF,25,1998,21.7,39,21,12,22,5,22,43,51.2,21,23,4,19,12,51,17,0,https://fbref.com/en/players/e9241b40/Luca-de-la-Torre
2024,Celta Vigo,La Liga,Yoel Lago,ESP,DF,19,2004,1,2,0,2,0,0,0,0,NA,0,1,0,1,0,2,2,0,https://fbref.com/en/players/edd4e7a5/Yoel-Lago
2024,Celta Vigo,La Liga,Javier Manquillo,ESP,"DF,MF",29,1994,8.3,15,11,6,5,4,8,15,53.3,7,14,3,11,3,18,17,0,https://fbref.com/en/players/758dd7f0/Javier-Manquillo
2024,Celta Vigo,La Liga,Óscar Mingueza,ESP,"DF,MF",24,1999,33.3,62,38,44,11,7,37,80,46.3,43,38,7,31,17,79,49,2,https://fbref.com/en/players/056269d7/Oscar-Mingueza
2024,Celta Vigo,La Liga,Unai Núñez,ESP,DF,26,1997,31.1,51,28,30,19,2,23,49,46.9,26,38,24,14,52,103,153,3,https://fbref.com/en/players/be170419/Unai-Nunez
2024,Celta Vigo,La Liga,Carles Pérez,ESP,"MF,DF",25,1998,8.6,13,5,6,5,2,7,18,38.9,11,14,1,13,5,18,8,0,https://fbref.com/en/players/a8f21b9f/Carles-Perez
2024,Celta Vigo,La Liga,Mihailo Ristić,SRB,"DF,MF",27,1995,9,15,9,9,6,0,9,12,75,3,9,2,7,10,25,23,0,https://fbref.com/en/players/ea0aa7e0/Mihailo-Ristic
2024,Celta Vigo,La Liga,Damián Rodríguez,ESP,MF,20,2003,2.9,6,3,1,3,2,1,3,33.3,2,4,2,2,1,7,2,0,https://fbref.com/en/players/22371dee/Damian-Rodriguez
2024,Celta Vigo,La Liga,Miguel Rodríguez,ESP,MF,20,2003,3.3,6,3,3,1,2,3,9,33.3,6,8,0,8,4,10,0,0,https://fbref.com/en/players/958d67bb/Miguel-Rodriguez
2024,Celta Vigo,La Liga,Javier Rueda Garcia,ESP,"MF,DF",21,2002,0.2,0,0,0,0,0,0,0,NA,0,0,0,0,0,0,0,0,https://fbref.com/en/players/9ace87ba/Javier-Rueda-Garcia
2024,Celta Vigo,La Liga,Manu Sánchez,ESP,"DF,MF",22,2000,19.7,54,28,21,25,8,31,55,56.4,24,23,3,20,19,73,65,0,https://fbref.com/en/players/ffacd3d5/Manu-Sanchez
2024,Celta Vigo,La Liga,Jailson Siqueira,BRA,"DF,MF",27,1995,10,27,18,22,5,0,13,24,54.2,11,13,5,8,12,39,32,0,https://fbref.com/en/players/b4819112/Jailson-Siqueira
2024,Celta Vigo,La Liga,Hugo Sotelo,ESP,MF,19,2003,8,19,17,3,13,3,8,20,40,12,7,1,6,2,21,5,0,https://fbref.com/en/players/3aa74860/Hugo-Sotelo
2024,Celta Vigo,La Liga,Carl Starfelt,SWE,DF,28,1995,24.6,36,30,30,5,1,19,28,67.9,9,35,28,7,34,70,159,2,https://fbref.com/en/players/5cfec13d/Carl-Starfelt
2024,Celta Vigo,La Liga,Jørgen Strand Larsen,NOR,FW,23,2000,31.8,21,11,1,15,5,8,38,21.1,30,15,1,14,5,26,17,0,https://fbref.com/en/players/f553b2b3/Jorgen-Strand-Larsen
2024,Celta Vigo,La Liga,Williot Swedberg,SWE,"FW,MF",19,2004,4.9,9,4,3,6,0,5,8,62.5,3,11,1,10,0,9,4,0,https://fbref.com/en/players/184fe4b2/Williot-Swedberg
2024,Celta Vigo,La Liga,Renato Tapia,PER,"MF,DF",28,1995,14.9,41,29,19,19,3,14,25,56,11,31,7,24,21,62,50,1,https://fbref.com/en/players/34269bdf/Renato-Tapia
2024,Celta Vigo,La Liga,Kevin Vázquez,ESP,DF,30,1993,7.8,15,13,7,7,1,12,21,57.1,9,11,3,8,5,20,25,0,https://fbref.com/en/players/ee923664/Kevin-Vazquez
2024,Celta Vigo,La Liga,Gabriel Veiga,ESP,FW,21,2002,0.2,0,0,0,0,0,0,0,NA,0,0,0,0,0,0,0,0,https://fbref.com/en/players/35a6e5c7/Gabriel-Veiga
2024,Celta Vigo,La Liga,Iván Villar,ESP,GK,26,1997,11.3,0,0,0,0,0,0,1,0,1,0,0,0,0,0,6,0,https://fbref.com/en/players/cde52ef5/Ivan-Villar
2024,Cádiz,La Liga,Rubén Alcaraz,ESP,MF,32,1991,34.8,97,59,39,52,6,50,121,41.3,71,60,14,46,33,130,55,2,https://fbref.com/en/players/036bba5f/Ruben-Alcaraz
2024,Cádiz,La Liga,Iván Alejo,ESP,MF,28,1995,18.8,40,23,23,11,6,17,57,29.8,40,20,0,20,7,47,17,0,https://fbref.com/en/players/3d7e48ce/Ivan-Alejo
2024,Cádiz,La Liga,Isaac Carcelen,ESP,DF,30,1993,29,50,31,30,15,5,25,45,55.6,20,24,7,17,27,77,87,2,https://fbref.com/en/players/c4b888df/Isaac-Carcelen
2024,Cádiz,La Liga,Víctor Chust,ESP,DF,23,2000,20.7,29,18,23,5,1,18,32,56.3,14,27,21,6,11,40,92,1,https://fbref.com/en/players/ec1a731e/Victor-Chust
2024,Cádiz,La Liga,Moussa Diakité,MLI,MF,19,2003,0,0,0,0,0,0,0,0,NA,0,0,0,0,0,0,0,0,https://fbref.com/en/players/d925b04e/Moussa-Diakite
2024,Cádiz,La Liga,Gonzalo Escalante,ARG,MF,30,1993,18.9,39,24,16,14,9,20,55,36.4,35,23,5,18,26,65,33,2,https://fbref.com/en/players/3f79a1c8/Gonzalo-Escalante
2024,Cádiz,La Liga,Karl Etta,CMR,FW,19,2003,0.2,1,1,0,1,0,0,0,NA,0,0,0,0,0,1,0,0,https://fbref.com/en/players/f0f499ea/Karl-Etta
2024,Cádiz,La Liga,Fali,ESP,DF,29,1993,28.3,41,26,29,11,1,21,36,58.3,15,38,24,14,27,68,120,0,https://fbref.com/en/players/72a84002/Fali
2024,Cádiz,La Liga,Álex Fernández,ESP,MF,30,1992,14.3,19,9,10,9,0,11,22,50,11,17,5,12,15,34,30,0,https://fbref.com/en/players/aa677a35/Alex-Fernandez
2024,Cádiz,La Liga,David Gil,ESP,GK,29,1994,4.1,0,0,0,0,0,0,1,0,1,0,0,0,0,0,3,0,https://fbref.com/en/players/fea23125/David-Gil
2024,Cádiz,La Liga,Maxi Gómez,URU,FW,26,1996,12.9,6,4,2,3,1,3,5,60,2,8,3,5,3,9,3,0,https://fbref.com/en/players/4c2e9442/Maxi-Gomez
2024,Cádiz,La Liga,Sergi Guardiola,ESP,"FW,MF",32,1991,5.5,10,7,2,6,2,4,9,44.4,5,10,0,10,0,10,4,0,https://fbref.com/en/players/32974271/Sergi-Guardiola
2024,Cádiz,La Liga,Javi Hernández,ESP,DF,25,1998,27.9,43,24,26,12,5,25,46,54.3,21,34,9,25,19,62,72,1,https://fbref.com/en/players/9a76c2e9/Javi-Hernandez
2024,Cádiz,La Liga,Luis Hernández,ESP,DF,34,1989,8,7,3,4,3,0,4,8,50,4,3,2,1,8,15,25,0,https://fbref.com/en/players/02d2c436/Luis-Hernandez
2024,Cádiz,La Liga,Juanmi,ESP,FW,30,1993,9.7,9,4,2,7,0,2,9,22.2,7,6,0,6,6,15,3,0,https://fbref.com/en/players/84399660/Juanmi
2024,Cádiz,La Liga,Rominigue Kouamé,MLI,MF,26,1996,9.1,14,9,6,7,1,7,15,46.7,8,10,2,8,13,27,10,1,https://fbref.com/en/players/86a2ba20/Rominigue-Kouame
2024,Cádiz,La Liga,Jeremías Ledesma,ARG,GK,30,1993,33.9,1,1,1,0,0,1,4,25,3,0,0,0,0,1,15,3,https://fbref.com/en/players/6c4776b1/Jeremias-Ledesma
2024,Cádiz,La Liga,Lucas,BRA,DF,22,2001,17.1,47,27,32,11,4,32,55,58.2,23,27,4,23,17,64,45,0,https://fbref.com/en/players/5d68f5b2/Lucas
2024,Cádiz,La Liga,Darwin Machís,VEN,MF,30,1993,8.7,23,14,7,9,7,13,24,54.2,11,8,1,7,4,27,2,0,https://fbref.com/en/players/ed6ea4d9/Darwin-Machis
2024,Cádiz,La Liga,José Mari,ESP,"MF,FW",35,1987,0.2,2,1,0,2,0,1,2,50,1,0,0,0,0,2,0,0,https://fbref.com/en/players/6f4c734d/Jose-Mari
2024,Cádiz,La Liga,Roger Martí,ESP,FW,32,1991,15.1,12,6,1,9,2,2,7,28.6,5,16,1,15,7,19,4,0,https://fbref.com/en/players/0ae4e09a/Roger-Marti
2024,Cádiz,La Liga,Mamadou Mbaye,SEN,DF,25,1998,3.2,6,3,3,3,0,2,5,40,3,10,7,3,5,11,26,0,https://fbref.com/en/players/8aae94b9/Mamadou-Mbaye
2024,Cádiz,La Liga,Jorge Meré,ESP,DF,26,1997,7.5,8,7,6,2,0,4,7,57.1,3,5,3,2,8,16,33,0,https://fbref.com/en/players/9f979eb2/Jorge-Mere
2024,Cádiz,La Liga,Roberto Navarro,ESP,"MF,FW",21,2002,21,46,29,20,21,5,22,43,51.2,21,33,0,33,19,65,7,1,https://fbref.com/en/players/c997b942/Roberto-Navarro
2024,Cádiz,La Liga,Álvaro Negredo,ESP,"FW,MF",37,1985,0.6,0,0,0,0,0,0,0,NA,0,1,0,1,1,1,0,0,https://fbref.com/en/players/63b0ca6b/Alvaro-Negredo
2024,Cádiz,La Liga,Brian Ocampo,URU,"MF,FW",24,1999,2.8,4,3,1,3,0,2,5,40,3,4,0,4,3,7,0,0,https://fbref.com/en/players/2e3995cd/Brian-Ocampo
2024,Cádiz,La Liga,Milutin Osmajić,MNE,MF,24,1999,0.1,0,0,0,0,0,0,0,NA,0,0,0,0,0,0,0,0,https://fbref.com/en/players/375ed9d7/Milutin-Osmajic
2024,Cádiz,La Liga,Aiham Ousou,SYR,DF,23,2000,4.8,8,5,6,2,0,5,5,100,0,1,0,1,7,15,15,0,https://fbref.com/en/players/2973a975/Aiham-Ousou
2024,Cádiz,La Liga,Chris Ramos,ESP,"FW,MF",26,1997,29,28,15,9,15,4,8,27,29.6,19,23,7,16,9,37,44,0,https://fbref.com/en/players/44e07fac/Chris-Ramos
2024,Cádiz,La Liga,Diadie Samassékou,MLI,MF,27,1996,1,5,3,2,2,1,5,6,83.3,1,0,0,0,3,8,1,0,https://fbref.com/en/players/08593525/Diadie-Samassekou
2024,Cádiz,La Liga,Fede San Emeterio,ESP,MF,26,1997,1.7,3,2,2,1,0,1,4,25,3,3,2,1,2,5,1,0,https://fbref.com/en/players/efecd633/Fede-San-Emeterio
2024,Cádiz,La Liga,Rubén Sobrino,ESP,"MF,FW",31,1992,18.3,52,28,18,26,8,22,51,43.1,29,26,2,24,16,68,18,0,https://fbref.com/en/players/19b776e9/Ruben-Sobrino
2024,Cádiz,La Liga,Borja Vázquez,ESP,FW,18,2005,0,1,0,1,0,0,1,1,100,0,0,0,0,0,1,1,0,https://fbref.com/en/players/8c6d0e32/Borja-Vazquez
2024,Cádiz,La Liga,Joseba Zaldúa,ESP,DF,31,1992,7.8,20,12,17,2,1,13,21,61.9,8,6,4,2,2,22,20,0,https://fbref.com/en/players/5ca20b7a/Joseba-Zaldua
2024,Getafe,La Liga,Nabil Aberdin,FRA,DF,20,2002,2,0,0,0,0,0,0,1,0,1,0,0,0,0,0,4,0,https://fbref.com/en/players/cadfa7d1/Nabil-Aberdin
2024,Getafe,La Liga,Omar Alderete,PAR,DF,26,1996,24.4,28,21,15,13,0,19,35,54.3,16,30,18,12,13,41,111,0,https://fbref.com/en/players/bb08bce9/Omar-Alderete
2024,Getafe,La Liga,Carles Aleñá,ESP,MF,25,1998,11.3,24,8,7,14,3,10,24,41.7,14,14,3,11,4,28,13,0,https://fbref.com/en/players/6c811eb7/Carles-Alena
2024,Getafe,La Liga,Gastón Álvarez,URU,DF,23,2000,28.2,68,37,43,20,5,37,57,64.9,20,40,11,29,35,103,80,0,https://fbref.com/en/players/852ddfb8/Gaston-Alvarez
2024,Getafe,La Liga,Fabrizio Angileri,ARG,"DF,MF",29,1994,1.8,1,1,1,0,0,1,3,33.3,2,0,0,0,4,5,8,0,https://fbref.com/en/players/fdd26d71/Fabrizio-Angileri
2024,Getafe,La Liga,Mauro Arambarri,URU,MF,27,1995,3.8,6,2,3,2,1,1,6,16.7,5,1,0,1,2,8,7,0,https://fbref.com/en/players/58afe001/Mauro-Arambarri
2024,Getafe,La Liga,Carmona,ESP,"DF,MF",21,2002,14.6,30,21,13,14,3,9,28,32.1,19,15,2,13,21,51,25,0,https://fbref.com/en/players/2dce876a/Carmona
2024,Getafe,La Liga,Djené,TOG,"DF,MF",31,1991,27.6,34,19,18,13,3,15,26,57.7,11,31,15,16,23,57,70,0,https://fbref.com/en/players/a4971d84/Djene
2024,Getafe,La Liga,Domingos Duarte,POR,DF,28,1995,10.1,7,4,6,0,1,5,7,71.4,2,7,5,2,8,15,27,0,https://fbref.com/en/players/93090f69/Domingos-Duarte
2024,Getafe,La Liga,Daniel Fuzato,BRA,GK,26,1997,0.1,0,0,0,0,0,0,0,NA,0,0,0,0,0,0,1,0,https://fbref.com/en/players/82328faf/Daniel-Fuzato
2024,Getafe,La Liga,Santiago García,ESP,FW,21,2001,0.3,1,0,0,0,1,1,1,100,0,0,0,0,0,1,0,0,https://fbref.com/en/players/b4b4d0a6/Santiago-Garcia
2024,Getafe,La Liga,Mason Greenwood,ENG,"MF,FW",21,2001,29.6,11,6,3,5,3,4,21,19,17,9,0,9,4,15,4,0,https://fbref.com/en/players/58eee997/Mason-Greenwood
2024,Getafe,La Liga,Iglesias,ESP,"DF,FW",25,1998,15.7,41,22,25,11,5,21,33,63.6,12,18,7,11,16,57,53,0,https://fbref.com/en/players/974322dc/Iglesias
2024,Getafe,La Liga,Jordi,ESP,"MF,DF",22,2001,6.4,16,11,3,11,2,7,15,46.7,8,7,2,5,8,24,7,0,https://fbref.com/en/players/5556d20b/Jordi
2024,Getafe,La Liga,Jeremy Jorge,ESP,FW,20,2003,0,0,0,0,0,0,0,0,NA,0,0,0,0,0,0,0,0,https://fbref.com/en/players/454d07c9/Jeremy-Jorge
2024,Getafe,La Liga,Juanmi Latasa,ESP,FW,22,2001,17.3,9,7,0,6,3,1,11,9.1,10,9,0,9,4,13,21,0,https://fbref.com/en/players/2bea832e/Juanmi-Latasa
2024,Getafe,La Liga,Anthony Lozano,HON,"MF,FW",30,1993,1,0,0,0,0,0,0,1,0,1,0,0,0,0,0,1,0,https://fbref.com/en/players/38699c72/Anthony-Lozano
2024,Getafe,La Liga,Nemanja Maksimović,SRB,MF,28,1995,36.3,65,43,26,31,8,23,41,56.1,18,56,23,33,46,111,61,0,https://fbref.com/en/players/00b28772/Nemanja-Maksimovic
2024,Getafe,La Liga,Jaime Mata,ESP,"FW,MF",34,1988,19.9,24,15,12,8,4,11,26,42.3,15,18,1,17,17,41,31,0,https://fbref.com/en/players/02319ad7/Jaime-Mata
2024,Getafe,La Liga,Borja Mayoral,ESP,FW,26,1997,23.9,9,5,2,2,5,5,22,22.7,17,7,0,7,4,13,16,0,https://fbref.com/en/players/64e8ed6d/Borja-Mayoral
2024,Getafe,La Liga,Luis Milla,ESP,MF,28,1994,23.5,57,33,19,28,10,28,47,59.6,19,20,1,19,32,89,10,0,https://fbref.com/en/players/19c36442/Luis-Milla
2024,Getafe,La Liga,Stefan Mitrović,SRB,DF,33,1990,7.8,9,3,7,2,0,4,8,50,4,3,2,1,6,15,26,0,https://fbref.com/en/players/e6777e6b/Stefan-Mitrovic
2024,Getafe,La Liga,Ilaix Moriba,GUI,"MF,FW",20,2003,6.7,20,11,3,11,6,4,9,44.4,5,3,1,2,4,24,10,0,https://fbref.com/en/players/f4c69aa6/Ilaix-Moriba
2024,Getafe,La Liga,Portu,ESP,FW,31,1992,1.1,5,3,4,0,1,5,6,83.3,1,0,0,0,0,5,0,0,https://fbref.com/en/players/1bda5842/Portu
2024,Getafe,La Liga,Diego Rico,ESP,DF,30,1993,28.2,64,48,32,23,9,41,76,53.9,35,25,8,17,41,105,76,0,https://fbref.com/en/players/d9ba39fc/Diego-Rico
2024,Getafe,La Liga,Alberto Risco,ESP,MF,17,2005,1.5,2,2,1,1,0,0,4,0,4,0,0,0,0,2,1,0,https://fbref.com/en/players/36286814/Alberto-Risco
2024,Getafe,La Liga,Gorka Rivera Alonso,ESP,DF,18,2004,0,0,0,0,0,0,0,0,NA,0,0,0,0,0,0,0,0,https://fbref.com/en/players/f1124008/Gorka-Rivera-Alonso
2024,Getafe,La Liga,Óscar Rodríguez Arnaiz,ESP,"MF,FW",25,1998,10.7,24,13,2,15,7,9,15,60,6,12,1,11,5,29,5,0,https://fbref.com/en/players/19709006/Oscar-Rodriguez-Arnaiz
2024,Getafe,La Liga,Jesús Santiago,ESP,MF,19,2004,7.3,17,8,8,5,4,4,7,57.1,3,3,0,3,0,17,8,0,https://fbref.com/en/players/bc49fd34/Jesus-Santiago
2024,Getafe,La Liga,David Soria,ESP,GK,30,1993,37.9,0,0,0,0,0,0,2,0,2,0,0,0,0,0,21,6,https://fbref.com/en/players/8f8c6934/David-Soria
2024,Getafe,La Liga,Damián Suárez,URU,DF,35,1988,14.4,36,21,16,16,4,26,45,57.8,19,13,3,10,10,46,31,0,https://fbref.com/en/players/ba5004e1/Damian-Suarez
2024,Getafe,La Liga,Yassin Tallal,ESP,FW,18,2005,0,0,0,0,0,0,0,0,NA,0,0,0,0,0,0,0,0,https://fbref.com/en/players/8388ba65/Yassin-Tallal
2024,Getafe,La Liga,Enes Ünal,TUR,"FW,MF",26,1997,1.6,0,0,0,0,0,0,0,NA,0,1,0,1,0,0,2,0,https://fbref.com/en/players/f8eca1b6/Enes-Unal
2024,Girona,La Liga,Daley Blind,NED,DF,33,1990,33,47,21,33,13,1,29,47,61.7,18,37,19,18,21,68,113,0,https://fbref.com/en/players/691bef82/Daley-Blind
2024,Girona,La Liga,Silvi Clúa,ESP,MF,18,2005,0,2,0,2,0,0,2,2,100,0,1,0,1,0,2,0,0,https://fbref.com/en/players/b793dea2/Silvi-Clua
2024,Girona,La Liga,Yan Couto,BRA,"DF,FW",21,2002,24.9,45,34,25,14,6,20,40,50,20,14,2,12,10,55,31,1,https://fbref.com/en/players/1944818c/Yan-Couto
2024,Girona,La Liga,Artem Dovbyk,UKR,FW,26,1997,28.7,4,3,2,1,1,0,2,0,2,8,1,7,0,4,17,0,https://fbref.com/en/players/5b847bb0/Artem-Dovbyk
2024,Girona,La Liga,Bernardo Espinosa,COL,DF,34,1989,0,1,1,1,0,0,1,1,100,0,0,0,0,0,1,2,0,https://fbref.com/en/players/4242011c/Bernardo-Espinosa
2024,Girona,La Liga,Valery Fernández,ESP,"MF,FW",23,1999,5.6,11,9,4,7,0,6,8,75,2,6,1,5,1,12,4,0,https://fbref.com/en/players/4acd733a/Valery-Fernandez
2024,Girona,La Liga,Aleix García,ESP,MF,26,1997,35.5,49,28,17,26,6,28,54,51.9,26,45,17,28,36,85,53,3,https://fbref.com/en/players/a10361d2/Aleix-Garcia
2024,Girona,La Liga,Eric García,ESP,DF,22,2001,29.3,55,37,34,18,3,34,49,69.4,15,36,18,18,30,85,79,2,https://fbref.com/en/players/2bed3eab/Eric-Garcia
2024,Girona,La Liga,Jastin García,ESP,FW,19,2004,0.4,1,0,0,0,1,0,0,NA,0,0,0,0,0,1,1,0,https://fbref.com/en/players/0302f7b4/Jastin-Garcia
2024,Girona,La Liga,Paulo Gazzaniga,ARG,GK,31,1992,38,2,2,2,0,0,2,4,50,2,0,0,0,0,2,12,1,https://fbref.com/en/players/63d17038/Paulo-Gazzaniga
2024,Girona,La Liga,Miguel Gutiérrez,ESP,DF,22,2001,33.7,29,18,11,14,4,13,35,37.1,22,27,11,16,22,51,66,2,https://fbref.com/en/players/7e98cff1/Miguel-Gutierrez
2024,Girona,La Liga,Yangel Herrera,VEN,MF,25,1998,23.4,64,37,28,30,6,30,56,53.6,26,30,8,22,24,88,45,1,https://fbref.com/en/players/5083a734/Yangel-Herrera
2024,Girona,La Liga,Juanpe,ESP,DF,32,1991,8.3,11,8,8,3,0,9,10,90,1,17,11,6,7,18,50,1,https://fbref.com/en/players/1633fc8a/Juanpe
2024,Girona,La Liga,Ibrahima Kebe,MLI,MF,22,2000,0.1,1,1,0,1,0,0,0,NA,0,1,0,1,1,2,0,0,https://fbref.com/en/players/047759a0/Ibrahima-Kebe
2024,Girona,La Liga,David López,ESP,DF,33,1989,21.8,33,20,21,12,0,17,22,77.3,5,28,19,9,20,53,63,4,https://fbref.com/en/players/f03f284b/David-Lopez
2024,Girona,La Liga,Iván Martín,ESP,MF,24,1999,30.3,44,25,22,15,7,22,57,38.6,35,25,3,22,21,65,14,0,https://fbref.com/en/players/ae48c5cb/Ivan-Martin
2024,Girona,La Liga,Arnau Martinez,ESP,DF,20,2003,13.8,25,16,17,6,2,15,32,46.9,17,15,5,10,10,35,41,3,https://fbref.com/en/players/c3e66ffe/Arnau-Martinez
2024,Girona,La Liga,Portu,ESP,"MF,FW",31,1992,13.2,18,13,3,10,5,3,18,16.7,15,9,1,8,4,22,6,0,https://fbref.com/en/players/1bda5842/Portu
2024,Girona,La Liga,Sávio,BRA,"FW,MF",19,2004,33.1,42,25,14,22,6,16,28,57.1,12,34,0,34,18,60,11,1,https://fbref.com/en/players/fe6e7156/Savio
2024,Girona,La Liga,Jhon Solis,COL,MF,18,2004,4.3,10,8,4,5,1,4,12,33.3,8,8,3,5,8,18,7,1,https://fbref.com/en/players/1282939a/Jhon-Solis
2024,Girona,La Liga,Cristhian Stuani,URU,FW,36,1986,8.9,14,11,4,6,4,4,7,57.1,3,9,2,7,5,19,13,0,https://fbref.com/en/players/220c11f1/Cristhian-Stuani
2024,Girona,La Liga,Pablo Torre,ESP,"MF,FW",20,2003,7.8,5,2,0,5,0,4,10,40,6,10,2,8,4,9,6,1,https://fbref.com/en/players/04e531b6/Pablo-Torre
2024,Girona,La Liga,Viktor Tsyhankov,UKR,"MF,FW",25,1997,22.8,29,20,11,13,5,14,26,53.8,12,18,1,17,12,41,24,0,https://fbref.com/en/players/f7e87032/Viktor-Tsyhankov
2024,Girona,La Liga,Toni Villa,ESP,FW,28,1995,0.1,0,0,0,0,0,0,0,NA,0,0,0,0,0,0,0,0,https://fbref.com/en/players/636eae97/Toni-Villa
2024,Girona,La Liga,Antal Yaakobishvili,HUN,DF,19,2004,0.7,2,1,1,1,0,1,1,100,0,0,0,0,3,5,3,0,https://fbref.com/en/players/cd59a7e6/Antal-Yaakobishvili
2024,Granada,La Liga,Miguel Ángel Rubio,ESP,DF,25,1998,17.3,20,12,14,6,0,14,21,66.7,7,31,18,13,28,48,74,2,https://fbref.com/en/players/56cafd0a/Miguel-Angel-Rubio
2024,Granada,La Liga,Matias Arezo,URU,FW,20,2002,4.1,7,3,2,5,0,1,5,20,4,4,1,3,1,8,4,0,https://fbref.com/en/players/484ebdb0/Matias-Arezo
2024,Granada,La Liga,Augusto Batalla,ARG,GK,27,1996,17,0,0,0,0,0,0,1,0,1,0,0,0,0,0,10,2,https://fbref.com/en/players/fc627681/Augusto-Batalla
2024,Granada,La Liga,Adri Bosch,ESP,DF,22,2001,0.3,1,1,1,0,0,0,0,NA,0,0,0,0,0,1,1,0,https://fbref.com/en/players/cb1e5807/Adri-Bosch
2024,Granada,La Liga,Lucas Boyé,ARG,FW,27,1996,28.2,50,25,14,25,11,14,34,41.2,20,35,5,30,10,60,46,0,https://fbref.com/en/players/d49f3e6b/Lucas-Boye
2024,Granada,La Liga,Brau,ESP,DF,21,2001,0.3,1,0,1,0,0,1,1,100,0,0,0,0,0,1,2,0,https://fbref.com/en/players/3e707ad4/Brau
2024,Granada,La Liga,José Callejón,ESP,"MF,FW",36,1987,8.9,13,6,10,3,0,8,22,36.4,14,7,1,6,5,18,10,0,https://fbref.com/en/players/78841da9/Jose-Callejon
2024,Granada,La Liga,Álvaro Carreras,ESP,"MF,FW",20,2003,5.3,13,8,8,4,1,5,11,45.5,6,5,1,4,7,20,9,1,https://fbref.com/en/players/33a68b9b/Alvaro-Carreras
2024,Granada,La Liga,Theo Corbeanu,CAN,"MF,FW",21,2002,2,5,2,2,3,0,1,3,33.3,2,3,0,3,3,8,2,0,https://fbref.com/en/players/25b82f9a/Theo-Corbeanu
2024,Granada,La Liga,Víctor Díaz,ESP,"DF,MF",35,1988,1.8,5,3,2,3,0,1,3,33.3,2,1,0,1,1,6,8,0,https://fbref.com/en/players/3624ce4c/Victor-Diaz
2024,Granada,La Liga,Famara Diedhiou,SEN,"FW,MF",30,1992,1,1,1,0,1,0,0,1,0,1,0,0,0,0,1,2,0,https://fbref.com/en/players/e447352c/Famara-Diedhiou
2024,Granada,La Liga,Raúl Fernández,ESP,GK,35,1988,3.1,0,0,0,0,0,0,1,0,1,0,0,0,0,0,1,2,https://fbref.com/en/players/6fb59070/Raul-Fernandez
2024,Granada,La Liga,André Ferreira,POR,GK,27,1996,14.9,0,0,0,0,0,0,1,0,1,0,0,0,0,0,9,2,https://fbref.com/en/players/12c6cbef/Andre-Ferreira
2024,Granada,La Liga,Gerard Gumbau,ESP,MF,28,1994,29.7,55,34,21,30,4,23,62,37.1,39,24,5,19,25,80,30,2,https://fbref.com/en/players/ac454a4f/Gerard-Gumbau
2024,Granada,La Liga,Martin Hongla,CMR,"MF,DF",25,1998,6.2,7,3,2,5,0,3,9,33.3,6,6,3,3,6,13,13,1,https://fbref.com/en/players/b85bf253/Martin-Hongla
2024,Granada,La Liga,Kamil Jóźwiak,POL,MF,25,1998,6.3,13,10,4,6,3,9,17,52.9,8,4,0,4,2,15,6,0,https://fbref.com/en/players/bd4e3824/Kamil-Jozwiak
2024,Granada,La Liga,Wilson Manafá,POR,"DF,MF",29,1994,2.7,6,4,3,2,1,4,7,57.1,3,1,0,1,1,7,4,1,https://fbref.com/en/players/e27fdbca/Wilson-Manafa
2024,Granada,La Liga,Faitout Maouassa,FRA,"DF,MF",25,1998,2.5,8,5,6,1,1,4,5,80,1,6,0,6,1,9,3,0,https://fbref.com/en/players/e54a9890/Faitout-Maouassa
2024,Granada,La Liga,Marc Martínez,ESP,GK,33,1990,3,0,0,0,0,0,0,1,0,1,0,0,0,0,0,1,0,https://fbref.com/en/players/3496ff67/Marc-Martinez
2024,Granada,La Liga,Óscar Melendo,ESP,"MF,FW",25,1997,12.5,14,6,4,10,0,4,12,33.3,8,13,0,13,5,19,4,1,https://fbref.com/en/players/379652be/Oscar-Melendo
2024,Granada,La Liga,Bruno Méndez,URU,DF,23,1999,14.8,36,17,19,12,5,21,37,56.8,16,24,6,18,26,62,45,0,https://fbref.com/en/players/66017b9d/Bruno-Mendez
2024,Granada,La Liga,Ignasi Miquel,ESP,DF,30,1992,33.2,47,30,39,6,2,23,40,57.5,17,32,16,16,45,92,132,4,https://fbref.com/en/players/174f09a6/Ignasi-Miquel
2024,Granada,La Liga,Carlos Neva,ESP,DF,27,1996,35,32,21,22,9,1,17,40,42.5,23,39,14,25,30,62,108,2,https://fbref.com/en/players/8d47bb39/Carlos-Neva
2024,Granada,La Liga,Samu Omorodion,ESP,FW,19,2004,0.9,1,1,0,1,0,1,1,100,0,0,0,0,0,1,0,0,https://fbref.com/en/players/dc44b03c/Samu-Omorodion
2024,Granada,La Liga,Facundo Pellistri,URU,"MF,FW",21,2001,13.7,29,19,12,10,7,6,21,28.6,15,18,0,18,4,33,7,0,https://fbref.com/en/players/ac7e7b1c/Facundo-Pellistri
2024,Granada,La Liga,Alberto Perea,ESP,"MF,FW",32,1990,0,0,0,0,0,0,0,2,0,2,0,0,0,0,0,0,0,https://fbref.com/en/players/5496cc91/Alberto-Perea
2024,Granada,La Liga,Njegoš Petrović,SRB,"MF,FW",24,1999,1.7,5,2,4,1,0,2,3,66.7,1,2,0,2,1,6,3,0,https://fbref.com/en/players/0cb29e91/Njegos-Petrovic
2024,Granada,La Liga,Kamil Piątkowski,POL,DF,23,2000,5.6,18,10,16,1,1,10,14,71.4,4,6,5,1,8,26,28,1,https://fbref.com/en/players/2cf496fb/Kamil-Piatkowski
2024,Granada,La Liga,Antonio Puertas,ESP,"MF,FW",31,1992,8.1,12,8,6,5,1,6,15,40,9,5,0,5,6,18,4,0,https://fbref.com/en/players/c77a8043/Antonio-Puertas
2024,Granada,La Liga,Sergio Rodelas,ESP,"FW,DF",18,2004,1.4,3,2,1,0,2,0,3,0,3,0,0,0,0,3,0,0,https://fbref.com/en/players/2c9e6bc3/Sergio-Rodelas
2024,Granada,La Liga,Sergio Ruiz,ESP,MF,28,1994,27.7,83,46,43,36,4,38,84,45.2,46,24,6,18,28,111,43,1,https://fbref.com/en/players/1f423a54/Sergio-Ruiz
2024,Granada,La Liga,Pablo Saenz,ESP,MF,22,2001,0.2,3,3,2,0,1,1,3,33.3,2,0,0,0,0,3,0,0,https://fbref.com/en/players/2f9ef1a8/Pablo-Saenz
2024,Granada,La Liga,Ricard Sánchez,ESP,DF,23,2000,25.5,29,18,15,8,6,12,24,50,12,32,4,28,13,42,64,0,https://fbref.com/en/players/fce521d7/Ricard-Sanchez
2024,Granada,La Liga,Alberto Soro,ESP,MF,24,1999,0.1,0,0,0,0,0,0,0,NA,0,0,0,0,0,0,0,0,https://fbref.com/en/players/452c3055/Alberto-Soro
2024,Granada,La Liga,Raúl Torrente,ESP,DF,21,2001,13.9,29,16,20,9,0,17,22,77.3,5,16,10,6,11,40,68,2,https://fbref.com/en/players/4d753a3f/Raul-Torrente
2024,Granada,La Liga,Myrto Uzuni,ALB,FW,28,1995,27.2,18,14,8,7,3,6,27,22.2,21,19,3,16,4,22,7,0,https://fbref.com/en/players/01da7812/Myrto-Uzuni
2024,Granada,La Liga,Jesús Vallejo,ESP,DF,26,1997,1.2,3,1,1,2,0,2,2,100,0,3,2,1,0,3,1,1,https://fbref.com/en/players/c2111b45/Jesus-Vallejo
2024,Granada,La Liga,Gonzalo Villar,ESP,MF,25,1998,20,51,33,26,20,5,26,41,63.4,15,32,10,22,6,57,26,1,https://fbref.com/en/players/bdc74a8f/Gonzalo-Villar
2024,Granada,La Liga,Shon Weissman,ISR,FW,27,1996,0.9,1,1,0,0,1,1,4,25,3,3,0,3,0,1,1,0,https://fbref.com/en/players/379dc075/Shon-Weissman
2024,Granada,La Liga,Bryan Zaragoza,ESP,"MF,FW",22,2001,18.2,18,9,8,6,4,8,23,34.8,15,9,0,9,3,21,3,0,https://fbref.com/en/players/a96103b2/Bryan-Zaragoza
2024,Las Palmas,La Liga,Julian Araujo,MEX,DF,21,2001,16.2,41,22,29,7,5,23,33,69.7,10,23,16,7,10,51,52,1,https://fbref.com/en/players/8f4541c2/Julian-Araujo
2024,Las Palmas,La Liga,José Campaña,ESP,MF,30,1993,1.9,2,2,1,1,0,0,2,0,2,3,2,1,2,4,3,0,https://fbref.com/en/players/61220da2/Jose-Campana
2024,Las Palmas,La Liga,Marc Cardona,ESP,FW,28,1995,8.2,9,8,3,4,2,1,12,8.3,11,5,0,5,2,11,7,0,https://fbref.com/en/players/b92b456a/Marc-Cardona
2024,Las Palmas,La Liga,Sergi Cardona,ESP,DF,24,1999,31.3,90,55,52,29,9,55,96,57.3,41,45,7,38,46,136,102,0,https://fbref.com/en/players/74e90475/Sergi-Cardona
2024,Las Palmas,La Liga,Saúl Coco,EQG,DF,24,1999,25.5,32,19,25,7,0,11,18,61.1,7,27,15,12,20,52,120,3,https://fbref.com/en/players/d0ee1652/Saul-Coco
2024,Las Palmas,La Liga,Eric Curbelo,ESP,"DF,MF",29,1994,1.1,4,3,2,2,0,3,4,75,1,3,1,2,2,6,5,1,https://fbref.com/en/players/34e39a18/Eric-Curbelo
2024,Las Palmas,La Liga,Aarón Escandell,ESP,GK,27,1995,1.7,0,0,0,0,0,0,0,NA,0,0,0,0,0,0,1,1,https://fbref.com/en/players/67669ce7/Aaron-Escandell
2024,Las Palmas,La Liga,Fabio González,ESP,MF,26,1997,1.4,2,2,2,0,0,1,2,50,1,2,0,2,0,2,0,0,https://fbref.com/en/players/5418d47c/Fabio-Gonzalez
2024,Las Palmas,La Liga,Iñaki González,ESP,MF,19,2004,0.1,1,0,1,0,0,0,0,NA,0,0,0,0,0,1,1,0,https://fbref.com/en/players/63787ec5/Inaki-Gonzalez
2024,Las Palmas,La Liga,Munir El Haddadi,MAR,FW,27,1995,27.2,40,27,18,17,5,17,38,44.7,21,27,1,26,11,51,16,0,https://fbref.com/en/players/8696bc90/Munir-El-Haddadi
2024,Las Palmas,La Liga,Cristian Herrera,ESP,"FW,MF",32,1991,1.8,1,1,0,1,0,1,2,50,1,1,0,1,0,1,2,0,https://fbref.com/en/players/f814e5d3/Cristian-Herrera
2024,Las Palmas,La Liga,Juan Herzog,ESP,DF,20,2003,3.2,6,5,5,1,0,3,6,50,3,4,1,3,2,8,17,0,https://fbref.com/en/players/3a18abe2/Juan-Herzog
2024,Las Palmas,La Liga,Sory Kaba,GUI,FW,28,1995,8,2,0,0,2,0,0,5,0,5,6,0,6,0,2,9,0,https://fbref.com/en/players/d29202c2/Sory-Kaba
2024,Las Palmas,La Liga,Álvaro Lemos,ESP,DF,30,1993,2.8,4,1,1,3,0,0,2,0,2,3,1,2,2,6,4,0,https://fbref.com/en/players/31d45cc8/Alvaro-Lemos
2024,Las Palmas,La Liga,Enzo Loiodice,FRA,MF,22,2000,19.9,62,35,15,34,13,20,42,47.6,22,20,2,18,12,74,16,1,https://fbref.com/en/players/6bca20fe/Enzo-Loiodice
2024,Las Palmas,La Liga,Mika Màrmol,ESP,DF,21,2002,35.3,70,42,44,24,2,35,53,66,18,39,19,20,44,114,147,2,https://fbref.com/en/players/e7630876/Mika-Marmol
2024,Las Palmas,La Liga,Marvin,ESP,"FW,DF",23,2000,20.6,39,25,18,17,4,18,36,50,18,28,2,26,14,53,18,1,https://fbref.com/en/players/efaefda0/Marvin
2024,Las Palmas,La Liga,Omenuke Mfulu,COD,"MF,FW",29,1994,0.9,4,3,3,1,0,0,1,0,1,1,1,0,2,6,5,0,https://fbref.com/en/players/bdc14559/Omenuke-Mfulu
2024,Las Palmas,La Liga,Alberto Moleiro,ESP,"FW,MF",19,2003,20,15,6,4,7,4,6,30,20,24,11,0,11,7,22,10,0,https://fbref.com/en/players/c2c8897d/Alberto-Moleiro
2024,Las Palmas,La Liga,Javier Muñoz,ESP,MF,28,1995,29.3,42,23,14,22,6,16,44,36.4,28,40,4,36,20,62,29,1,https://fbref.com/en/players/ec7c84c2/Javier-Munoz
2024,Las Palmas,La Liga,Pejiño,ESP,FW,27,1996,5.6,12,8,3,6,3,6,18,33.3,12,4,0,4,2,14,5,0,https://fbref.com/en/players/8c4e56cb/Pejino
2024,Las Palmas,La Liga,Máximo Perrone,ARG,MF,20,2003,18,42,21,17,22,3,19,39,48.7,20,27,4,23,24,66,21,0,https://fbref.com/en/players/53552942/Maximo-Perrone
2024,Las Palmas,La Liga,Benito Ramírez,ESP,"FW,MF",28,1995,4.3,5,3,2,3,0,3,6,50,3,7,1,6,3,8,0,0,https://fbref.com/en/players/db714daf/Benito-Ramirez
2024,Las Palmas,La Liga,Sandro Ramírez,ESP,FW,28,1995,20.1,12,8,4,6,2,6,15,40,9,13,1,12,4,16,14,1,https://fbref.com/en/players/833fb62e/Sandro-Ramirez
2024,Las Palmas,La Liga,Kirian Rodríguez,ESP,MF,27,1996,35.7,52,32,22,25,5,24,67,35.8,43,39,3,36,28,80,23,1,https://fbref.com/en/players/9b130479/Kirian-Rodriguez
2024,Las Palmas,La Liga,Daley Sinkgraven,NED,DF,28,1995,4.2,11,5,6,5,0,2,8,25,6,5,3,2,6,17,9,0,https://fbref.com/en/players/73000a79/Daley-Sinkgraven
2024,Las Palmas,La Liga,Álex Suárez,ESP,DF,30,1993,28.5,53,36,33,15,5,31,37,83.8,6,33,14,19,18,71,84,0,https://fbref.com/en/players/9c137b36/Alex-Suarez
2024,Las Palmas,La Liga,Álvaro Vallés,ESP,GK,26,1997,36.3,3,2,3,0,0,3,8,37.5,5,0,0,0,0,3,40,1,https://fbref.com/en/players/0166a73e/Alvaro-Valles
2024,Las Palmas,La Liga,Jonathan Viera,ESP,"MF,FW",33,1989,6.9,6,3,1,2,3,1,9,11.1,8,0,0,0,0,6,1,0,https://fbref.com/en/players/efa708aa/Jonathan-Viera
2024,Mallorca,La Liga,Amath,SEN,"FW,MF",27,1996,4.4,9,6,7,2,0,2,10,20,8,2,0,2,3,12,6,0,https://fbref.com/en/players/f3b1d9a2/Amath
2024,Mallorca,La Liga,Copete,ESP,DF,23,1999,14.8,45,27,27,17,1,30,43,69.8,13,12,6,6,32,77,47,1,https://fbref.com/en/players/0f26ffd7/Copete
2024,Mallorca,La Liga,Jaume Costa,ESP,DF,35,1988,18.7,38,22,23,10,5,18,29,62.1,11,14,4,10,16,54,35,0,https://fbref.com/en/players/808d48f3/Jaume-Costa
2024,Mallorca,La Liga,Samu Costa,POR,MF,22,2000,25.6,91,50,40,46,5,46,93,49.5,47,28,14,14,39,130,59,3,https://fbref.com/en/players/76c2a023/Samu-Costa
2024,Mallorca,La Liga,Iván Cuéllar,ESP,GK,39,1984,1,0,0,0,0,0,0,0,NA,0,0,0,0,0,0,0,0,https://fbref.com/en/players/75751c99/Ivan-Cuellar
2024,Mallorca,La Liga,Sergi Darder,ESP,MF,29,1993,24,39,26,13,21,5,12,31,38.7,19,20,4,16,16,55,16,0,https://fbref.com/en/players/070a3904/Sergi-Darder
2024,Mallorca,La Liga,Giovanni González,URU,DF,28,1994,27.4,73,45,37,32,4,40,81,49.4,41,24,3,21,31,104,60,2,https://fbref.com/en/players/1fc474ae/Giovanni-Gonzalez
2024,Mallorca,La Liga,Dominik Greif,SVK,GK,26,1997,1,0,0,0,0,0,0,0,NA,0,0,0,0,0,0,0,0,https://fbref.com/en/players/30061f53/Dominik-Greif
2024,Mallorca,La Liga,Cyle Larin,CAN,FW,28,1995,20.3,17,8,6,4,7,2,7,28.6,5,16,5,11,3,20,17,0,https://fbref.com/en/players/e7af9060/Cyle-Larin
2024,Mallorca,La Liga,Toni Lato,ESP,DF,25,1997,17.2,38,23,19,13,6,16,27,59.3,11,17,3,14,17,55,27,0,https://fbref.com/en/players/8e088e04/Toni-Lato
2024,Mallorca,La Liga,Javier Llabrés,ESP,"MF,FW",20,2002,2.7,3,1,1,1,1,1,2,50,1,1,0,1,3,6,4,0,https://fbref.com/en/players/38b0cf42/Javier-Llabres
2024,Mallorca,La Liga,Pablo Maffeo,ESP,DF,26,1997,16.2,35,22,18,13,4,23,40,57.5,17,12,2,10,10,45,23,0,https://fbref.com/en/players/5db04597/Pablo-Maffeo
2024,Mallorca,La Liga,Omar Mascarell,EQG,MF,30,1993,17.5,33,16,16,17,0,18,35,51.4,17,24,8,16,31,64,30,1,https://fbref.com/en/players/11fd2b75/Omar-Mascarell
2024,Mallorca,La Liga,Manu Morlanes,ESP,MF,24,1999,17.9,50,29,23,26,1,23,53,43.4,30,13,1,12,20,70,21,0,https://fbref.com/en/players/a0255c67/Manu-Morlanes
2024,Mallorca,La Liga,Vedat Muriqi,KVX,FW,29,1994,25.9,11,6,4,3,4,2,14,14.3,12,11,4,7,6,17,26,0,https://fbref.com/en/players/0cadc46d/Vedat-Muriqi
2024,Mallorca,La Liga,Matija Nastasić,SRB,DF,30,1993,25.1,35,17,26,9,0,24,32,75,8,33,20,13,29,64,114,0,https://fbref.com/en/players/f35430a4/Matija-Nastasic
2024,Mallorca,La Liga,Abdón Prats,ESP,"FW,MF",30,1992,14.1,6,4,2,2,2,3,5,60,2,6,3,3,2,8,12,0,https://fbref.com/en/players/d1b060e2/Abdon-Prats
2024,Mallorca,La Liga,Nemanja Radonjić,SRB,"MF,DF",27,1996,3.9,4,2,1,3,0,1,4,25,3,2,0,2,3,7,3,0,https://fbref.com/en/players/0630eb63/Nemanja-Radonjic
2024,Mallorca,La Liga,Antonio Raillo,ESP,DF,31,1991,24.4,30,23,18,12,0,17,23,73.9,6,44,30,14,37,67,104,2,https://fbref.com/en/players/b857bd29/Antonio-Raillo
2024,Mallorca,La Liga,Predrag Rajković,SRB,GK,27,1995,36,2,1,2,0,0,2,2,100,0,0,0,0,0,2,14,0,https://fbref.com/en/players/58ad9383/Predrag-Rajkovic
2024,Mallorca,La Liga,Dani Rodríguez,ESP,MF,35,1988,29.1,47,24,21,20,6,21,45,46.7,24,34,5,29,15,62,21,0,https://fbref.com/en/players/70f8e0bd/Dani-Rodriguez
2024,Mallorca,La Liga,Antonio Sánchez,ESP,MF,26,1997,16.1,25,11,13,10,2,11,32,34.4,21,24,5,19,13,38,13,0,https://fbref.com/en/players/a254bbe0/Antonio-Sanchez
2024,Mallorca,La Liga,Martin Valjent,SVK,DF,27,1995,26.1,34,18,19,13,2,18,30,60,12,26,11,15,29,63,112,1,https://fbref.com/en/players/f2c6ac01/Martin-Valjent
2024,Mallorca,La Liga,Siebe Van Der Heyden,BEL,DF,25,1998,3.2,9,2,7,2,0,4,6,66.7,2,1,1,0,7,16,12,0,https://fbref.com/en/players/cf9bdd43/Siebe-Van-Der-Heyden
2024,Mallorca,La Liga,Nacho Vidal,ESP,DF,28,1995,4.6,12,5,4,5,3,6,13,46.2,7,5,2,3,3,15,9,0,https://fbref.com/en/players/3a9c4b7b/Nacho-Vidal
2024,Osasuna,La Liga,Jesús Areso,ESP,DF,24,1999,29.6,45,24,25,13,7,31,38,81.6,7,36,15,21,18,63,58,0,https://fbref.com/en/players/94e01ec6/Jesus-Areso
2024,Osasuna,La Liga,Iñigo Arguibide,ESP,DF,18,2005,0.2,1,0,0,1,0,0,0,NA,0,0,0,0,0,1,1,0,https://fbref.com/en/players/d80d7f17/Inigo-Arguibide
2024,Osasuna,La Liga,José Arnaiz,ESP,"FW,MF",28,1995,10.3,14,8,6,4,4,6,21,28.6,15,11,2,9,3,17,2,0,https://fbref.com/en/players/46e07328/Jose-Arnaiz
2024,Osasuna,La Liga,Ezequiel Ávila,ARG,"FW,MF",29,1994,9.6,3,2,1,1,1,3,11,27.3,8,14,0,14,4,7,8,0,https://fbref.com/en/players/253a06b9/Ezequiel-Avila
2024,Osasuna,La Liga,Kike Barja,ESP,"FW,MF",26,1997,3.4,6,2,2,2,2,3,8,37.5,5,2,1,1,2,8,2,0,https://fbref.com/en/players/aad53e64/Kike-Barja
2024,Osasuna,La Liga,Darko Brašanac,SRB,MF,31,1992,0.5,1,0,1,0,0,1,1,100,0,1,0,1,0,1,0,0,https://fbref.com/en/players/4accb7e0/Darko-Brasanac
2024,Osasuna,La Liga,Ante Budimir,CRO,FW,32,1991,27.1,21,15,2,11,8,5,14,35.7,9,19,5,14,5,26,18,0,https://fbref.com/en/players/8f3565b3/Ante-Budimir
2024,Osasuna,La Liga,Catena,ESP,DF,28,1994,28.2,33,18,26,6,1,19,35,54.3,16,24,15,9,15,48,119,3,https://fbref.com/en/players/274ab13c/Catena
2024,Osasuna,La Liga,Juan Cruz Armada,ESP,DF,31,1992,18.5,27,15,16,10,1,17,25,68,8,14,7,7,12,39,39,1,https://fbref.com/en/players/a56da3ba/Juan-Cruz-Armada
2024,Osasuna,La Liga,Aitor Fernández,ESP,GK,32,1991,6.1,0,0,0,0,0,0,1,0,1,0,0,0,0,0,5,1,https://fbref.com/en/players/a01c3d54/Aitor-Fernandez
2024,Osasuna,La Liga,David García,ESP,DF,29,1994,25.9,29,18,19,9,1,16,26,61.5,10,40,19,21,18,47,115,2,https://fbref.com/en/players/3e42f707/David-Garcia
2024,Osasuna,La Liga,Rubén García,ESP,"FW,MF",30,1993,17.2,32,18,8,17,7,13,33,39.4,20,23,3,20,12,44,23,0,https://fbref.com/en/players/5c96b017/Ruben-Garcia
2024,Osasuna,La Liga,Unai García,ESP,DF,31,1992,6.2,12,9,9,2,1,5,10,50,5,7,1,6,8,20,18,0,https://fbref.com/en/players/4a633cfe/Unai-Garcia
2024,Osasuna,La Liga,Moi Gómez,ESP,"MF,FW",29,1994,22.3,30,19,7,19,4,9,24,37.5,15,15,1,14,11,41,22,0,https://fbref.com/en/players/5a626448/Moi-Gomez
2024,Osasuna,La Liga,Jorge Herrando,ESP,DF,22,2001,18.3,29,19,23,6,0,12,19,63.2,7,20,11,9,15,44,69,1,https://fbref.com/en/players/e19c989c/Jorge-Herrando
2024,Osasuna,La Liga,Sergio Herrera,ESP,GK,30,1993,31.9,2,2,2,0,0,2,3,66.7,1,0,0,0,0,2,22,3,https://fbref.com/en/players/a4995f48/Sergio-Herrera
2024,Osasuna,La Liga,Xabier Huarte Armendáriz,ESP,MF,22,2001,0.1,0,0,0,0,0,0,0,NA,0,0,0,0,0,0,0,0,https://fbref.com/en/players/e83e8928/Xabier-Huarte-Armendariz
2024,Osasuna,La Liga,Pablo Ibáñez,ESP,MF,24,1998,12.8,18,9,5,7,6,5,21,23.8,16,26,3,23,9,27,17,0,https://fbref.com/en/players/3701906c/Pablo-Ibanez
2024,Osasuna,La Liga,Johan Mojica,COL,DF,30,1992,22.7,30,22,11,15,4,16,25,64,9,15,2,13,21,51,40,2,https://fbref.com/en/players/608f2092/Johan-Mojica
2024,Osasuna,La Liga,Jon Moncayola,ESP,MF,25,1998,20,27,18,14,10,3,17,42,40.5,25,31,5,26,15,42,21,0,https://fbref.com/en/players/9939e168/Jon-Moncayola
2024,Osasuna,La Liga,Jorge Moreno,ESP,DF,22,2001,0.2,0,0,0,0,0,0,0,NA,0,1,0,1,0,0,3,0,https://fbref.com/en/players/1f875ef8/Jorge-Moreno
2024,Osasuna,La Liga,Iker Muñoz,ESP,MF,20,2002,20.6,32,18,13,17,2,15,31,48.4,16,16,5,11,11,43,50,0,https://fbref.com/en/players/175ece4c/Iker-Munoz
2024,Osasuna,La Liga,Aimar Oroz,ESP,MF,21,2001,26,43,26,18,20,5,13,37,35.1,24,27,2,25,16,59,11,0,https://fbref.com/en/players/7c363088/Aimar-Oroz
2024,Osasuna,La Liga,Asier Osambela,ESP,MF,19,2004,0.1,2,1,0,1,1,0,0,NA,0,0,0,0,0,2,0,0,https://fbref.com/en/players/e87c44a9/Asier-Osambela
2024,Osasuna,La Liga,Rubén Peña,ESP,"DF,FW",32,1991,23.2,47,25,22,18,7,20,49,40.8,29,37,8,29,30,77,39,3,https://fbref.com/en/players/1f079188/Ruben-Pena
2024,Osasuna,La Liga,Raúl,ESP,FW,22,2000,15.1,10,4,4,2,4,2,10,20,8,9,1,8,5,15,11,0,https://fbref.com/en/players/18f0a9f0/Raul
2024,Osasuna,La Liga,Max Svensson,ESP,FW,,NA,0,1,0,0,0,1,0,0,NA,0,0,0,0,0,1,0,0,https://fbref.com/en/players/cf603737/Max-Svensson
2024,Osasuna,La Liga,Lucas Torró,ESP,MF,29,1994,19.9,25,15,11,8,6,11,28,39.3,17,10,2,8,33,58,37,0,https://fbref.com/en/players/0e4fef6e/Lucas-Torro
2024,Osasuna,La Liga,Nacho Vidal,ESP,"DF,FW",28,1995,1.1,5,4,2,2,1,2,5,40,3,2,0,2,0,5,6,0,https://fbref.com/en/players/3a9c4b7b/Nacho-Vidal
2024,Rayo Vallecano,La Liga,Iván Balliu,ALB,DF,31,1992,31.9,44,31,20,24,0,22,39,56.4,17,27,11,16,29,73,66,1,https://fbref.com/en/players/cee88597/Ivan-Balliu
2024,Rayo Vallecano,La Liga,Bebé,CPV,"MF,FW",33,1990,2.4,2,2,1,1,0,1,5,20,4,1,0,1,0,2,0,0,https://fbref.com/en/players/d8712bf9/Bebe
2024,Rayo Vallecano,La Liga,Sergio Camello,ESP,FW,22,2001,18.5,16,5,3,10,3,6,15,40,9,10,2,8,3,19,15,0,https://fbref.com/en/players/873619c6/Sergio-Camello
2024,Rayo Vallecano,La Liga,Cárdenas,ESP,GK,26,1997,1,0,0,0,0,0,0,0,NA,0,0,0,0,0,0,1,0,https://fbref.com/en/players/e1846dde/Cardenas
2024,Rayo Vallecano,La Liga,Pep Chavarría,ESP,"DF,MF",25,1998,13,23,18,15,6,2,11,17,64.7,6,15,3,12,6,29,29,1,https://fbref.com/en/players/63c5e56b/Pep-Chavarria
2024,Rayo Vallecano,La Liga,Pathé Ciss,SEN,MF,29,1994,18.5,44,24,16,26,2,16,29,55.2,13,27,10,17,30,74,54,0,https://fbref.com/en/players/9a0408b6/Pathe-Ciss
2024,Rayo Vallecano,La Liga,Crespo,POR,MF,26,1996,5.9,16,9,8,6,2,9,17,52.9,8,15,6,9,10,26,7,0,https://fbref.com/en/players/922dfade/Crespo
2024,Rayo Vallecano,La Liga,Stole Dimitrievski,MKD,GK,29,1993,37,1,1,1,0,0,1,1,100,0,0,0,0,0,1,17,3,https://fbref.com/en/players/fc70e345/Stole-Dimitrievski
2024,Rayo Vallecano,La Liga,Alfonso Espino,URU,DF,31,1992,27.9,67,45,43,22,2,30,82,36.6,52,26,4,22,40,107,63,0,https://fbref.com/en/players/db001fa9/Alfonso-Espino
2024,Rayo Vallecano,La Liga,Radamel Falcao,COL,"FW,DF",37,1986,4.5,7,5,1,5,1,1,3,33.3,2,2,0,2,3,10,4,0,https://fbref.com/en/players/66116290/Radamel-Falcao
2024,Rayo Vallecano,La Liga,Jorge de Frutos,ESP,"FW,MF",26,1997,17.2,19,8,5,8,6,7,22,31.8,15,12,0,12,7,26,18,0,https://fbref.com/en/players/38ce1150/Jorge-de-Frutos
2024,Rayo Vallecano,La Liga,Álvaro García,ESP,"FW,MF",30,1992,27.5,34,25,15,10,9,7,34,20.6,27,35,0,35,36,70,33,0,https://fbref.com/en/players/90bbd822/Alvaro-Garcia
2024,Rayo Vallecano,La Liga,Aridane Hernández,ESP,DF,34,1989,18.8,10,8,5,4,1,4,11,36.4,7,19,14,5,14,24,98,1,https://fbref.com/en/players/132ac341/Aridane-Hernandez
2024,Rayo Vallecano,La Liga,Florian Lejeune,FRA,DF,32,1991,37,39,25,26,11,2,19,30,63.3,11,33,18,15,23,62,155,1,https://fbref.com/en/players/6eaed4eb/Florian-Lejeune
2024,Rayo Vallecano,La Liga,Unai López,ESP,MF,27,1995,23.4,48,24,18,23,7,21,53,39.6,32,24,3,21,16,64,15,2,https://fbref.com/en/players/88050721/Unai-Lopez
2024,Rayo Vallecano,La Liga,Diego Méndez,ESP,MF,19,2003,0.1,1,1,1,0,0,1,1,100,0,0,0,0,1,2,0,0,https://fbref.com/en/players/b151a3f2/Diego-Mendez
2024,Rayo Vallecano,La Liga,Abdul Mumin,GHA,DF,25,1998,18.8,19,10,13,4,2,8,10,80,2,27,19,8,22,41,82,1,https://fbref.com/en/players/5487adcd/Abdul-Mumin
2024,Rayo Vallecano,La Liga,Randy Nteka,ANG,"FW,MF",25,1997,6.4,11,4,1,6,4,4,10,40,6,6,1,5,2,13,11,1,https://fbref.com/en/players/a6103274/Randy-Nteka
2024,Rayo Vallecano,La Liga,Isaac Palazón Camacho,ESP,"MF,FW",28,1994,31,46,25,16,21,9,20,58,34.5,38,29,2,27,16,62,41,0,https://fbref.com/en/players/49dbab27/Isaac-Palazon-Camacho
2024,Rayo Vallecano,La Liga,Kike Pérez,ESP,"MF,FW",26,1997,9.3,27,11,11,15,1,11,23,47.8,12,11,0,11,8,35,6,0,https://fbref.com/en/players/237a3851/Kike-Perez
2024,Rayo Vallecano,La Liga,José Pozo,ESP,MF,27,1996,0.2,1,1,0,1,0,1,1,100,0,1,0,1,0,1,0,0,https://fbref.com/en/players/fc8b614b/Jose-Pozo
2024,Rayo Vallecano,La Liga,Andrei Ratiu,ROU,"DF,MF",25,1998,7,12,4,6,5,1,8,15,53.3,7,4,1,3,0,12,12,0,https://fbref.com/en/players/b1b99435/Andrei-Ratiu
2024,Rayo Vallecano,La Liga,Salvi,ESP,MF,32,1991,0.3,0,0,0,0,0,0,4,0,4,0,0,0,1,1,0,0,https://fbref.com/en/players/405f267a/Salvi
2024,Rayo Vallecano,La Liga,Raúl de Tomás,ESP,FW,28,1994,14.1,9,5,4,3,2,3,6,50,3,3,0,3,1,10,8,0,https://fbref.com/en/players/02ef8778/Raul-de-Tomas
2024,Rayo Vallecano,La Liga,Óscar Trejo,ARG,"FW,MF",35,1988,15.3,27,15,11,9,7,13,21,61.9,8,21,1,20,5,32,9,0,https://fbref.com/en/players/fc647b34/Oscar-Trejo
2024,Rayo Vallecano,La Liga,Óscar Valentín,ESP,MF,28,1994,29.9,107,66,39,62,6,46,101,45.5,55,62,10,52,35,142,52,1,https://fbref.com/en/players/592f3158/Oscar-Valentin
2024,Real Madrid,La Liga,David Alaba,AUT,DF,31,1992,12.8,13,9,7,5,1,4,8,50,4,10,7,3,15,28,34,0,https://fbref.com/en/players/05439de2/David-Alaba
2024,Real Madrid,La Liga,Kepa Arrizabalaga,ESP,GK,28,1994,13.3,0,0,0,0,0,0,1,0,1,0,0,0,0,0,4,0,https://fbref.com/en/players/28d596a0/Kepa-Arrizabalaga
2024,Real Madrid,La Liga,Jude Bellingham,ENG,MF,20,2003,25.7,42,34,14,18,10,12,36,33.3,24,55,5,50,21,63,17,0,https://fbref.com/en/players/57d88cf9/Jude-Bellingham
2024,Real Madrid,La Liga,Eduardo Camavinga,FRA,"MF,DF",20,2002,20.2,76,47,39,29,8,23,39,59,16,36,8,28,29,105,29,1,https://fbref.com/en/players/7b9c2d84/Eduardo-Camavinga
2024,Real Madrid,La Liga,Dani Carvajal,ESP,DF,31,1992,24.1,47,32,28,15,4,23,42,54.8,19,28,9,19,22,69,54,4,https://fbref.com/en/players/4958bfb2/Dani-Carvajal
2024,Real Madrid,La Liga,Dani Ceballos,ESP,"MF,FW",26,1996,6.6,10,5,4,5,1,5,14,35.7,9,9,2,7,0,10,4,1,https://fbref.com/en/players/c0617e2b/Dani-Ceballos
2024,Real Madrid,La Liga,Thibaut Courtois,BEL,GK,31,1992,3.7,1,0,1,0,0,0,0,NA,0,0,0,0,0,1,0,0,https://fbref.com/en/players/1840e36d/Thibaut-Courtois
2024,Real Madrid,La Liga,Brahim Díaz,MAR,"FW,MF",23,1999,17.2,29,19,4,16,9,6,13,46.2,7,16,1,15,5,34,2,0,https://fbref.com/en/players/407feb71/Brahim-Diaz
2024,Real Madrid,La Liga,Fran Garcia,ESP,DF,23,1999,15.5,25,17,11,12,2,13,31,41.9,18,16,3,13,19,44,28,1,https://fbref.com/en/players/7226539b/Fran-Garcia
2024,Real Madrid,La Liga,Gonzalo García,ESP,"FW,MF",19,2004,0.2,0,0,0,0,0,0,1,0,1,1,1,0,0,0,1,0,https://fbref.com/en/players/74c2d562/Gonzalo-Garcia
2024,Real Madrid,La Liga,Arda Güler,TUR,"FW,MF",18,2005,4.2,6,4,1,3,2,5,8,62.5,3,0,0,0,2,8,5,0,https://fbref.com/en/players/3741ca58/Arda-Guler
2024,Real Madrid,La Liga,Joselu,ESP,FW,33,1990,18.7,6,3,1,4,1,0,7,0,7,11,1,10,6,12,11,0,https://fbref.com/en/players/6265208f/Joselu
2024,Real Madrid,La Liga,Vinicius Júnior,BRA,FW,23,2000,20.7,18,13,5,5,8,3,12,25,9,13,0,13,1,19,3,2,https://fbref.com/en/players/7111d552/Vinicius-Junior
2024,Real Madrid,La Liga,Toni Kroos,GER,MF,33,1990,23.6,53,34,19,25,9,24,59,40.7,35,22,4,18,17,70,11,1,https://fbref.com/en/players/6ce1f46f/Toni-Kroos
2024,Real Madrid,La Liga,Andriy Lunin,UKR,GK,24,1999,21,0,0,0,0,0,0,1,0,1,0,0,0,0,0,15,1,https://fbref.com/en/players/3061e1ec/Andriy-Lunin
2024,Real Madrid,La Liga,Mario Martín,ESP,MF,19,2004,0.2,5,1,0,2,3,3,4,75,1,2,1,1,0,5,0,0,https://fbref.com/en/players/a9aff11a/Mario-Martin
2024,Real Madrid,La Liga,Ferland Mendy,FRA,DF,28,1995,19.1,15,10,12,2,1,11,14,78.6,3,12,2,10,13,28,26,1,https://fbref.com/en/players/3cefcaef/Ferland-Mendy
2024,Real Madrid,La Liga,Éder Militão,BRA,DF,25,1998,5.5,7,3,4,3,0,6,9,66.7,3,4,3,1,4,11,19,1,https://fbref.com/en/players/2784f898/Eder-Militao
2024,Real Madrid,La Liga,Luka Modrić,CRO,MF,37,1985,18.8,22,15,10,6,6,9,25,36,16,13,4,9,21,43,9,0,https://fbref.com/en/players/6025fab1/Luka-Modric
2024,Real Madrid,La Liga,Nacho,ESP,DF,33,1990,19.4,18,10,9,7,2,6,13,46.2,7,23,13,10,18,36,56,0,https://fbref.com/en/players/2946f9a1/Nacho
2024,Real Madrid,La Liga,Nicolás Paz,ARG,"MF,FW",18,2004,0.3,0,0,0,0,0,0,0,NA,0,2,0,2,1,1,0,0,https://fbref.com/en/players/01bb93d5/Nicolas-Paz
2024,Real Madrid,La Liga,Álvaro Rodríguez,URU,FW,19,2004,0,0,0,0,0,0,0,0,NA,0,0,0,0,0,0,1,0,https://fbref.com/en/players/49a6ecbb/Alvaro-Rodriguez
2024,Real Madrid,La Liga,Rodrygo,BRA,FW,22,2001,26.4,16,15,2,9,5,5,19,26.3,14,14,0,14,8,24,6,0,https://fbref.com/en/players/8f5e92a6/Rodrygo
2024,Real Madrid,La Liga,Antonio Rüdiger,GER,DF,30,1993,30.1,26,15,18,4,4,16,20,80,4,27,20,7,11,37,89,0,https://fbref.com/en/players/18b896d6/Antonio-Rudiger
2024,Real Madrid,La Liga,Aurélien Tchouaméni,FRA,"MF,DF",23,2000,22.1,38,23,19,17,2,9,18,50,9,21,13,8,28,66,52,1,https://fbref.com/en/players/4f255115/Aurelien-Tchouameni
2024,Real Madrid,La Liga,Federico Valverde,URU,MF,25,1998,32.3,47,34,22,13,12,24,42,57.1,18,39,2,37,43,90,40,0,https://fbref.com/en/players/0959c2a2/Federico-Valverde
2024,Real Madrid,La Liga,Lucas Vázquez,ESP,DF,32,1991,15.8,37,25,22,14,1,18,25,72,7,27,5,22,12,49,36,0,https://fbref.com/en/players/fd51b456/Lucas-Vazquez
2024,Real Sociedad,La Liga,Mohamed Ali Cho,FRA,"FW,MF",19,2004,2.8,4,3,3,1,0,2,7,28.6,5,6,0,6,1,5,1,0,https://fbref.com/en/players/f8405304/Mohamed-Ali-Cho
2024,Real Sociedad,La Liga,Jon Aramburu,VEN,DF,21,2002,6,24,15,12,10,2,15,25,60,10,8,3,5,7,31,17,0,https://fbref.com/en/players/dc7a172e/Jon-Aramburu
2024,Real Sociedad,La Liga,Ander Barrenetxea,ESP,"FW,MF",21,2001,15.9,32,21,7,16,9,10,26,38.5,16,18,1,17,6,38,5,0,https://fbref.com/en/players/200e89e1/Ander-Barrenetxea
2024,Real Sociedad,La Liga,Sheraldo Becker,SUR,"FW,MF",28,1995,8.6,2,2,0,2,0,0,1,0,1,3,0,3,1,3,0,0,https://fbref.com/en/players/8eb55dbb/Sheraldo-Becker
2024,Real Sociedad,La Liga,Alberto Dadie,ESP,MF,21,2002,0.3,2,1,2,0,0,0,0,NA,0,1,0,1,0,2,0,0,https://fbref.com/en/players/cc851506/Alberto-Dadie
2024,Real Sociedad,La Liga,Aritz Elustondo,ESP,DF,29,1994,9,11,7,5,4,2,6,14,42.9,8,12,10,2,7,18,26,0,https://fbref.com/en/players/f7dc2ae5/Aritz-Elustondo
2024,Real Sociedad,La Liga,Carlos Fernández,ESP,FW,27,1996,4.5,11,7,3,6,2,0,2,0,2,4,0,4,0,11,5,0,https://fbref.com/en/players/e08647d6/Carlos-Fernandez
2024,Real Sociedad,La Liga,Javi Galán,ESP,DF,28,1994,11.9,38,22,15,19,4,15,30,50,15,24,1,23,14,52,17,1,https://fbref.com/en/players/a4b00319/Javi-Galan
2024,Real Sociedad,La Liga,Urko González,ESP,MF,22,2001,1.7,4,1,0,3,1,2,2,100,0,1,0,1,1,5,6,0,https://fbref.com/en/players/c4f5eb61/Urko-Gonzalez
2024,Real Sociedad,La Liga,Takefusa Kubo,JPN,"FW,MF",22,2001,23.9,26,17,15,6,5,9,23,39.1,14,21,2,19,11,37,8,1,https://fbref.com/en/players/16aa3654/Takefusa-Kubo
2024,Real Sociedad,La Liga,Robin Le Normand,ESP,DF,26,1996,27.4,31,22,16,15,0,17,30,56.7,13,26,15,11,28,59,96,1,https://fbref.com/en/players/9a64e67e/Robin-Le-Normand
2024,Real Sociedad,La Liga,Jon Magunacelaya,ESP,"FW,MF",23,2000,1.3,5,3,2,3,0,4,8,50,4,3,0,3,0,5,2,0,https://fbref.com/en/players/d4808594/Jon-Magunacelaya
2024,Real Sociedad,La Liga,Unai Marrero,ESP,GK,21,2001,1.6,0,0,0,0,0,0,0,NA,0,0,0,0,0,0,0,0,https://fbref.com/en/players/f0fe87dc/Unai-Marrero
2024,Real Sociedad,La Liga,Jon Martin,ESP,DF,17,2006,0.3,0,0,0,0,0,0,0,NA,0,0,0,0,0,0,3,0,https://fbref.com/en/players/df33ecb5/Jon-Martin
2024,Real Sociedad,La Liga,Brais Méndez,ESP,"MF,FW",26,1997,26.8,42,28,13,20,9,15,43,34.9,28,23,4,19,12,54,21,0,https://fbref.com/en/players/c9e39d91/Brais-Mendez
2024,Real Sociedad,La Liga,Mikel Merino,ESP,MF,27,1996,27.6,77,43,25,34,18,22,48,45.8,26,36,11,25,16,93,55,3,https://fbref.com/en/players/d080ed5e/Mikel-Merino
2024,Real Sociedad,La Liga,Aihen Muñoz,ESP,DF,25,1997,12.5,36,21,20,10,6,24,35,68.6,11,16,8,8,9,45,33,0,https://fbref.com/en/players/228b0d9d/Aihen-Munoz
2024,Real Sociedad,La Liga,Álvaro Odriozola,ESP,DF,27,1995,4.4,9,7,7,1,1,5,5,100,0,2,1,1,8,17,7,0,https://fbref.com/en/players/1d1691ad/Alvaro-Odriozola
2024,Real Sociedad,La Liga,Olasagasti,ESP,MF,22,2000,4,16,13,4,7,5,5,8,62.5,3,2,0,2,3,19,5,1,https://fbref.com/en/players/3d99999d/Olasagasti
2024,Real Sociedad,La Liga,Mikel Oyarzabal,ESP,"FW,MF",26,1997,24,23,18,7,11,5,7,21,33.3,14,25,4,21,4,27,12,0,https://fbref.com/en/players/8c3c640c/Mikel-Oyarzabal
2024,Real Sociedad,La Liga,Jon Pacheco,ESP,DF,22,2001,17,25,15,21,4,0,14,22,63.6,8,17,6,11,10,35,53,1,https://fbref.com/en/players/44150beb/Jon-Pacheco
2024,Real Sociedad,La Liga,Álex Remiro,ESP,GK,28,1995,36.4,0,0,0,0,0,0,0,NA,0,0,0,0,0,0,24,2,https://fbref.com/en/players/374ee424/Alex-Remiro
2024,Real Sociedad,La Liga,Umar Sadiq,NGA,FW,26,1997,12,15,10,2,8,5,4,8,50,4,9,0,9,0,15,10,0,https://fbref.com/en/players/686cbe7d/Umar-Sadiq
2024,Real Sociedad,La Liga,André Silva,POR,FW,27,1995,8.1,2,2,0,0,2,0,4,0,4,3,0,3,1,3,3,0,https://fbref.com/en/players/3effaa34/Andre-Silva
2024,Real Sociedad,La Liga,Alex Sola,ESP,"DF,MF",24,1999,0.3,0,0,0,0,0,0,0,NA,0,0,0,0,1,1,2,0,https://fbref.com/en/players/5fa714d5/Alex-Sola
2024,Real Sociedad,La Liga,Kieran Tierney,SCO,DF,26,1997,13.8,37,24,16,18,3,18,27,66.7,9,22,8,14,10,47,45,0,https://fbref.com/en/players/fce2302c/Kieran-Tierney
2024,Real Sociedad,La Liga,Hamari Traoré,MLI,DF,31,1992,25.5,44,19,24,17,3,25,43,58.1,18,27,8,19,24,68,59,2,https://fbref.com/en/players/a4b1028a/Hamari-Traore
2024,Real Sociedad,La Liga,Beñat Turrientes,ESP,MF,21,2002,18.7,31,17,6,20,5,13,30,43.3,17,19,8,11,6,37,17,0,https://fbref.com/en/players/068f4dec/Benat-Turrientes
2024,Real Sociedad,La Liga,Arsen Zakharyan,RUS,"MF,FW",20,2003,13.6,22,15,8,11,3,9,22,40.9,13,16,0,16,4,26,10,0,https://fbref.com/en/players/7f14ec2a/Arsen-Zakharyan
2024,Real Sociedad,La Liga,Igor Zubeldia,ESP,DF,26,1997,28,32,25,20,10,2,19,26,73.1,7,28,19,9,32,64,97,3,https://fbref.com/en/players/5c7845f6/Igor-Zubeldia
2024,Real Sociedad,La Liga,Martín Zubimendi,ESP,MF,24,1999,29.5,49,27,18,29,2,23,42,54.8,19,33,9,24,37,86,54,0,https://fbref.com/en/players/3ee0dd59/Martin-Zubimendi
2024,Sevilla,La Liga,Marcos Acuña,ARG,DF,31,1991,14.4,33,21,20,12,1,9,14,64.3,5,12,2,10,4,37,25,0,https://fbref.com/en/players/81442ecb/Marcos-Acuna
2024,Sevilla,La Liga,Lucien Agoume,FRA,MF,21,2002,8.6,23,18,7,14,2,9,12,75,3,6,1,5,7,30,8,0,https://fbref.com/en/players/8bc8829a/Lucien-Agoume
2024,Sevilla,La Liga,Loïc Bade,FRA,DF,23,2000,25.3,65,41,53,12,0,30,49,61.2,19,23,15,8,38,103,116,2,https://fbref.com/en/players/114bbdee/Loic-Bade
2024,Sevilla,La Liga,Yassine Bounou,MAR,GK,32,1991,1,0,0,0,0,0,0,0,NA,0,0,0,0,0,0,0,0,https://fbref.com/en/players/f6798fc3/Yassine-Bounou
2024,Sevilla,La Liga,Manu Bueno,ESP,MF,19,2004,1.3,4,2,4,0,0,3,3,100,0,3,0,3,0,4,1,0,https://fbref.com/en/players/c5642098/Manu-Bueno
2024,Sevilla,La Liga,Jesús Corona,MEX,"MF,DF",30,1993,0.2,0,0,0,0,0,0,0,NA,0,0,0,0,1,1,0,0,https://fbref.com/en/players/fb938d24/Jesus-Corona
2024,Sevilla,La Liga,Marko Dmitrović,SRB,GK,31,1992,13,1,1,1,0,0,1,2,50,1,0,0,0,1,2,5,0,https://fbref.com/en/players/ac295d9e/Marko-Dmitrovic
2024,Sevilla,La Liga,Youssef En-Nesyri,MAR,FW,26,1997,28.6,10,7,3,4,3,0,10,0,10,9,1,8,7,17,29,1,https://fbref.com/en/players/04e17fd5/Youssef-En-Nesyri
2024,Sevilla,La Liga,Fernando,BRA,MF,36,1987,5.1,9,8,2,4,3,5,9,55.6,4,2,0,2,7,16,9,0,https://fbref.com/en/players/41f32541/Fernando
2024,Sevilla,La Liga,Federico Gattoni,ARG,"DF,FW",24,1999,0.1,1,0,1,0,0,1,1,100,0,0,0,0,0,1,1,0,https://fbref.com/en/players/86087757/Federico-Gattoni
2024,Sevilla,La Liga,Nemanja Gudelj,SRB,"DF,MF",31,1991,19.4,31,24,18,10,3,17,31,54.8,14,17,9,8,27,58,56,0,https://fbref.com/en/players/0076ab7f/Nemanja-Gudelj
2024,Sevilla,La Liga,Diego Iturralde,ESP,DF,20,2003,0.4,0,0,0,0,0,0,0,NA,0,1,1,0,0,0,2,0,https://fbref.com/en/players/9d33c71a/Diego-Iturralde
2024,Sevilla,La Liga,Adnan Januzaj,BEL,"FW,MF",28,1995,2.1,3,3,2,0,1,0,1,0,1,2,0,2,1,4,0,0,https://fbref.com/en/players/4737cebe/Adnan-Januzaj
2024,Sevilla,La Liga,Joan Jordán,ESP,MF,29,1994,4.2,8,7,3,3,2,7,15,46.7,8,4,2,2,4,12,2,0,https://fbref.com/en/players/2a0c8ba4/Joan-Jordan
2024,Sevilla,La Liga,Érik Lamela,ARG,"FW,MF",31,1992,5.1,21,14,4,10,7,10,15,66.7,5,12,0,12,1,22,5,0,https://fbref.com/en/players/abe66106/Erik-Lamela
2024,Sevilla,La Liga,Dodi Lukebakio,BEL,"FW,MF",25,1997,12.5,5,2,2,2,1,1,6,16.7,5,9,2,7,2,7,5,0,https://fbref.com/en/players/0c61c77c/Dodi-Lukebakio
2024,Sevilla,La Liga,Marcão,BRA,DF,27,1996,3.9,9,6,5,4,0,6,10,60,4,8,6,2,4,13,11,1,https://fbref.com/en/players/133faa84/Marcao
2024,Sevilla,La Liga,Mariano,DOM,"FW,MF",29,1993,2.7,1,1,0,1,0,0,1,0,1,1,0,1,0,1,2,0,https://fbref.com/en/players/5c4dc0ff/Mariano
2024,Sevilla,La Liga,Hannibal Mejbri,TUN,MF,20,2003,1.2,3,3,1,2,0,0,1,0,1,1,0,1,0,3,0,0,https://fbref.com/en/players/ca22ccb0/Hannibal-Mejbri
2024,Sevilla,La Liga,Rafa Mir,ESP,"FW,MF",26,1997,4.3,2,2,1,1,0,1,2,50,1,2,0,2,1,3,1,0,https://fbref.com/en/players/bbf5c11b/Rafa-Mir
2024,Sevilla,La Liga,Jesús Navas,ESP,DF,37,1985,22.3,37,27,21,14,2,22,40,55,18,15,7,8,22,59,48,0,https://fbref.com/en/players/3f10bd22/Jesus-Navas
2024,Sevilla,La Liga,Tanguy Nianzou,FRA,DF,21,2002,3.5,12,8,9,2,1,8,11,72.7,3,2,0,2,3,15,9,1,https://fbref.com/en/players/5853ac44/Tanguy-Nianzou
2024,Sevilla,La Liga,Ørjan Nyland,NOR,GK,32,1990,24,0,0,0,0,0,0,1,0,1,0,0,0,0,0,9,1,https://fbref.com/en/players/bdedffac/Orjan-Nyland
2024,Sevilla,La Liga,Lucas Ocampos,ARG,"FW,MF",29,1994,31.9,66,47,22,27,17,29,58,50,29,34,1,33,21,87,29,0,https://fbref.com/en/players/a08b974a/Lucas-Ocampos
2024,Sevilla,La Liga,Adrià Pedrosa,ESP,DF,25,1998,19.5,46,26,28,14,4,23,34,67.6,11,26,6,20,15,61,54,0,https://fbref.com/en/players/112521d1/Adria-Pedrosa
2024,Sevilla,La Liga,Ivan Rakitić,CRO,MF,35,1988,15.8,30,16,9,12,9,11,19,57.9,8,16,5,11,14,44,12,0,https://fbref.com/en/players/89f951b5/Ivan-Rakitic
2024,Sevilla,La Liga,Sergio Ramos,ESP,DF,37,1986,28,45,30,32,11,2,27,40,67.5,13,35,30,5,41,86,156,0,https://fbref.com/en/players/08511d65/Sergio-Ramos
2024,Sevilla,La Liga,Isaac Romero,ESP,FW,23,2000,11.5,6,3,2,2,2,5,9,55.6,4,12,0,12,0,6,11,0,https://fbref.com/en/players/be719093/Isaac-Romero
2024,Sevilla,La Liga,Kike Salas,ESP,DF,21,2002,17.8,41,23,26,12,3,22,36,61.1,14,25,14,11,26,67,91,1,https://fbref.com/en/players/0a69de7b/Kike-Salas
2024,Sevilla,La Liga,Juanlu Sánchez,ESP,DF,19,2003,13.1,56,35,34,18,4,34,58,58.6,24,24,7,17,12,68,36,0,https://fbref.com/en/players/cc6de655/Juanlu-Sanchez
2024,Sevilla,La Liga,Boubakary Soumaré,FRA,MF,24,1999,25.4,39,28,24,14,1,14,26,53.8,12,25,7,18,26,65,20,1,https://fbref.com/en/players/ae59b359/Boubakary-Soumare
2024,Sevilla,La Liga,Djibril Sow,SUI,MF,26,1997,16.2,28,21,15,8,5,9,25,36,16,20,3,17,17,45,8,1,https://fbref.com/en/players/4c6facae/Djibril-Sow
2024,Sevilla,La Liga,Suso,ESP,"MF,FW",29,1993,16.9,24,17,14,8,2,8,28,28.6,20,9,0,9,5,29,4,0,https://fbref.com/en/players/4e219ad2/Suso
2024,Sevilla,La Liga,Óliver Torres,ESP,MF,28,1994,18,37,22,17,15,5,22,57,38.6,35,40,4,36,6,43,6,0,https://fbref.com/en/players/58a9a4d9/Oliver-Torres
2024,Sevilla,La Liga,Alejo Véliz,ARG,FW,19,2003,0.4,1,0,0,1,0,1,2,50,1,0,0,0,0,1,1,0,https://fbref.com/en/players/3f7bafbe/Alejo-Veliz
2024,Valencia,La Liga,Domingos André Ribeiro Almeida,POR,"FW,MF",23,2000,10.7,25,15,9,12,4,9,19,47.4,10,13,1,12,6,31,5,0,https://fbref.com/en/players/e6697917/Domingos-Andre-Ribeiro-Almeida
2024,Valencia,La Liga,Selim Amallah,MAR,"FW,MF",26,1996,6.7,17,12,7,7,3,3,9,33.3,6,13,0,13,11,28,6,0,https://fbref.com/en/players/00eba9c9/Selim-Amallah
2024,Valencia,La Liga,Sergi Canós,ESP,"MF,FW",26,1997,13.7,23,13,7,11,5,10,24,41.7,14,14,2,12,11,34,9,0,https://fbref.com/en/players/1137759d/Sergi-Canos
2024,Valencia,La Liga,Thierry Correia,POR,DF,24,1999,23.9,63,35,39,20,4,28,49,57.1,21,39,16,23,33,96,61,0,https://fbref.com/en/players/c78b352d/Thierry-Correia
2024,Valencia,La Liga,Cristian,ESP,GK,25,1998,0.6,0,0,0,0,0,0,0,NA,0,0,0,0,0,0,0,0,https://fbref.com/en/players/9ad74b4d/Cristian
2024,Valencia,La Liga,Mouctar Diakhaby,GUI,"DF,MF",26,1996,11.9,18,11,9,9,0,11,13,84.6,2,17,7,10,11,29,62,0,https://fbref.com/en/players/d2110326/Mouctar-Diakhaby
2024,Valencia,La Liga,Jaume Doménech,ESP,GK,32,1990,0.9,0,0,0,0,0,0,0,NA,0,0,0,0,0,0,0,0,https://fbref.com/en/players/c9cb972b/Jaume-Domenech
2024,Valencia,La Liga,Mario Dominguez,ESP,FW,19,2004,0.3,0,0,0,0,0,0,0,NA,0,0,0,0,0,0,0,0,https://fbref.com/en/players/d709cd5c/Mario-Dominguez
2024,Valencia,La Liga,Hugo Duro,ESP,FW,23,1999,33.1,16,8,5,8,3,9,29,31,20,24,5,19,5,21,27,0,https://fbref.com/en/players/37e103f8/Hugo-Duro
2024,Valencia,La Liga,Peter Federico,DOM,"MF,FW",21,2002,7.2,5,3,3,1,1,1,10,10,9,11,0,11,7,12,10,0,https://fbref.com/en/players/1ccd3dae/Peter-Federico
2024,Valencia,La Liga,Dimitri Foulquier,FRA,"DF,MF",30,1993,20.5,39,22,22,13,4,18,26,69.2,8,10,1,9,16,55,49,1,https://fbref.com/en/players/45e17712/Dimitri-Foulquier
2024,Valencia,La Liga,Yarek Gasiorowski,ESP,DF,18,2005,8.2,22,12,14,5,3,13,19,68.4,6,15,8,7,15,37,50,1,https://fbref.com/en/players/20a65cdf/Yarek-Gasiorowski
2024,Valencia,La Liga,Hugo González,ESP,"MF,FW",20,2003,1,2,1,0,2,0,0,0,NA,0,0,0,0,0,2,0,0,https://fbref.com/en/players/2cfb6e88/Hugo-Gonzalez
2024,Valencia,La Liga,Pablo Gozalbez,ESP,"MF,FW",22,2001,1.1,1,0,0,0,1,1,6,16.7,5,0,0,0,1,2,2,0,https://fbref.com/en/players/f33b6ee6/Pablo-Gozalbez
2024,Valencia,La Liga,Javier Guerra,ESP,MF,20,2003,27.8,54,24,25,22,7,22,58,37.9,36,27,7,20,18,72,44,0,https://fbref.com/en/players/3828f130/Javier-Guerra
2024,Valencia,La Liga,Hugo Guillamón,ESP,MF,23,2000,14.6,24,15,7,14,3,11,17,64.7,6,8,3,5,12,36,25,2,https://fbref.com/en/players/f7c12fbf/Hugo-Guillamon
2024,Valencia,La Liga,Ruben Lendinez,ESP,DF,20,2003,0.1,2,2,0,2,0,1,1,100,0,0,0,0,0,2,1,0,https://fbref.com/en/players/755da865/Ruben-Lendinez
2024,Valencia,La Liga,Diego López,ESP,"MF,FW",21,2002,29.5,37,25,14,16,7,13,56,23.2,43,23,1,22,20,57,12,0,https://fbref.com/en/players/c487901c/Diego-Lopez
2024,Valencia,La Liga,José Luis Gayà,ESP,DF,28,1995,19.9,71,36,44,23,4,43,67,64.2,24,18,3,15,11,82,42,0,https://fbref.com/en/players/b05e2dbd/Jose-Luis-Gaya
2024,Valencia,La Liga,Giorgi Mamardashvili,GEO,GK,22,2000,36.5,4,3,4,0,0,4,4,100,0,1,0,1,2,6,22,2,https://fbref.com/en/players/d4b73232/Giorgi-Mamardashvili
2024,Valencia,La Liga,Alberto Marí,ESP,FW,22,2001,3.1,4,2,0,1,3,1,1,100,0,3,0,3,0,4,5,0,https://fbref.com/en/players/44330c36/Alberto-Mari
2024,Valencia,La Liga,Cristhian Mosquera,ESP,DF,19,2004,34.2,57,34,36,18,3,25,39,64.1,14,42,23,19,36,93,137,2,https://fbref.com/en/players/dc1ce4f5/Cristhian-Mosquera
2024,Valencia,La Liga,Cenk Özkacar,TUR,DF,22,2000,17.8,26,15,22,4,0,15,23,65.2,8,18,7,11,18,44,84,1,https://fbref.com/en/players/9a93efc9/Cenk-Ozkacar
2024,Valencia,La Liga,Gabriel Paulista,BRA,DF,32,1990,15.5,10,7,8,2,0,6,11,54.5,5,15,7,8,24,34,78,0,https://fbref.com/en/players/b7ca5c51/Gabriel-Paulista
2024,Valencia,La Liga,Francisco Perez,ESP,"MF,FW",20,2002,22.8,30,17,10,14,6,15,44,34.1,29,19,0,19,14,44,5,0,https://fbref.com/en/players/3d79a68c/Francisco-Perez
2024,Valencia,La Liga,César Tárrega,ESP,DF,21,2002,0.1,0,0,0,0,0,0,0,NA,0,0,0,0,0,0,2,0,https://fbref.com/en/players/59c29820/Cesar-Tarrega
2024,Valencia,La Liga,José Luis García Vayá,ESP,MF,24,1998,36.7,78,53,36,36,6,37,71,52.1,34,41,10,31,49,127,71,0,https://fbref.com/en/players/27dc1378/Jose-Luis-Garcia-Vaya
2024,Valencia,La Liga,Jesus Vazquez,ESP,"DF,MF",20,2003,8,24,12,13,8,3,10,16,62.5,6,17,4,13,3,27,24,0,https://fbref.com/en/players/106c142c/Jesus-Vazquez
2024,Valencia,La Liga,Roman Yaremchuk,UKR,FW,27,1995,10.3,5,2,1,2,2,3,6,50,3,4,0,4,1,6,9,0,https://fbref.com/en/players/cb641b9d/Roman-Yaremchuk
2024,Villarreal,La Liga,Ilias Akhomach,MAR,"MF,FW",19,2004,16.8,36,21,11,16,9,10,20,50,10,10,2,8,13,49,13,0,https://fbref.com/en/players/b8bd60fe/Ilias-Akhomach
2024,Villarreal,La Liga,Raúl Albiol,ESP,DF,37,1985,22.6,25,14,15,9,1,18,27,66.7,9,31,24,7,16,41,102,0,https://fbref.com/en/players/4bd414c1/Raul-Albiol
2024,Villarreal,La Liga,Adrià Altimira,ESP,"DF,MF",22,2001,8.6,16,7,9,6,1,9,24,37.5,15,18,5,13,5,21,18,0,https://fbref.com/en/players/757a3431/Adria-Altimira
2024,Villarreal,La Liga,Alex Baena,ESP,"MF,FW",22,2001,28.7,34,21,10,16,8,20,47,42.6,27,23,2,21,13,47,17,1,https://fbref.com/en/players/518f2234/Alex-Baena
2024,Villarreal,La Liga,Eric Bailly,CIV,DF,29,1994,9.3,5,3,4,1,0,2,2,100,0,8,8,0,9,14,38,2,https://fbref.com/en/players/a1232f4e/Eric-Bailly
2024,Villarreal,La Liga,Ben Brereton,CHI,"FW,MF",24,1999,3,2,2,1,0,1,0,2,0,2,0,0,0,0,2,0,0,https://fbref.com/en/players/57827369/Ben-Brereton
2024,Villarreal,La Liga,Étienne Capoue,FRA,MF,35,1988,16.2,32,18,17,12,3,15,22,68.2,7,20,4,16,22,54,24,1,https://fbref.com/en/players/5acc4a10/Etienne-Capoue
2024,Villarreal,La Liga,Santi Comesaña,ESP,MF,26,1996,18.4,44,26,15,21,8,19,38,50,19,33,9,24,22,66,27,1,https://fbref.com/en/players/5ae499d0/Santi-Comesana
2024,Villarreal,La Liga,Francis Coquelin,FRA,MF,32,1991,10.1,20,12,8,10,2,5,13,38.5,8,14,4,10,16,36,15,0,https://fbref.com/en/players/a6951bf8/Francis-Coquelin
2024,Villarreal,La Liga,Jorge Cuenca,ESP,DF,23,1999,21.8,42,29,26,10,6,19,30,63.3,11,26,15,11,21,63,114,0,https://fbref.com/en/players/0abc51f2/Jorge-Cuenca
2024,Villarreal,La Liga,Kiko Femenía,ESP,DF,32,1991,17.6,35,25,19,13,3,19,34,55.9,15,21,6,15,31,66,45,0,https://fbref.com/en/players/e5d01ecf/Kiko-Femenia
2024,Villarreal,La Liga,Juan Foyth,ARG,DF,25,1998,11.8,26,15,18,8,0,12,27,44.4,15,17,4,13,12,38,44,0,https://fbref.com/en/players/6c7762c3/Juan-Foyth
2024,Villarreal,La Liga,Matteo Gabbia,ITA,DF,23,1999,5.3,10,6,4,6,0,5,8,62.5,3,5,2,3,8,18,36,1,https://fbref.com/en/players/c235e803/Matteo-Gabbia
2024,Villarreal,La Liga,Gonçalo Guedes,POR,"FW,MF",26,1996,10.6,6,4,1,2,3,2,7,28.6,5,8,0,8,2,8,3,0,https://fbref.com/en/players/e6bc67d7/Goncalo-Guedes
2024,Villarreal,La Liga,Filip Jørgensen,DEN,GK,21,2002,36,3,1,3,0,0,3,4,75,1,0,0,0,2,5,10,3,https://fbref.com/en/players/0107757e/Filip-Jorgensen
2024,Villarreal,La Liga,Stefan Lekovic,SRB,DF,19,2004,0.3,0,0,0,0,0,0,0,NA,0,1,1,0,0,0,1,0,https://fbref.com/en/players/d633fd46/Stefan-Lekovic
2024,Villarreal,La Liga,José Luis Morales,ESP,"FW,MF",36,1987,11.6,5,3,1,4,0,3,13,23.1,10,9,1,8,7,12,4,0,https://fbref.com/en/players/4a478107/Jose-Luis-Morales
2024,Villarreal,La Liga,Aïssa Mandi,ALG,DF,31,1991,12.4,13,8,8,5,0,7,14,50,7,10,7,3,8,21,41,0,https://fbref.com/en/players/fbd6378b/Aissa-Mandi
2024,Villarreal,La Liga,Alberto Moreno,ESP,DF,31,1992,16.5,31,21,19,10,2,10,30,33.3,20,12,2,10,24,55,33,0,https://fbref.com/en/players/11b9265b/Alberto-Moreno
2024,Villarreal,La Liga,Gerard Moreno,ESP,FW,31,1992,24.6,25,12,10,7,8,11,25,44,14,24,7,17,9,34,24,0,https://fbref.com/en/players/81f0781e/Gerard-Moreno
2024,Villarreal,La Liga,Yerson Mosquera,COL,DF,22,2001,13.7,27,13,18,7,2,12,15,80,3,12,2,10,17,44,65,0,https://fbref.com/en/players/1e159d70/Yerson-Mosquera
2024,Villarreal,La Liga,Daniel Parejo,ESP,MF,34,1989,28.7,43,30,16,21,6,20,46,43.5,26,25,9,16,21,64,29,3,https://fbref.com/en/players/7460ca0d/Daniel-Parejo
2024,Villarreal,La Liga,Pascu,ESP,FW,20,2003,0.2,0,0,0,0,0,0,0,NA,0,0,0,0,0,0,0,0,https://fbref.com/en/players/a2d9cf74/Pascu
2024,Villarreal,La Liga,Alfonso Pedraza,ESP,DF,27,1996,12.4,25,9,18,5,2,9,17,52.9,8,16,7,9,13,38,19,0,https://fbref.com/en/players/63f04c6c/Alfonso-Pedraza
2024,Villarreal,La Liga,Yeremi Pino,ESP,"MF,FW",20,2002,5.3,25,18,12,10,3,9,18,50,9,11,1,10,5,30,5,0,https://fbref.com/en/players/540ec57b/Yeremi-Pino
2024,Villarreal,La Liga,Pepe Reina,ESP,GK,40,1982,2,0,0,0,0,0,0,0,NA,0,0,0,0,0,0,1,0,https://fbref.com/en/players/e358587b/Pepe-Reina
2024,Villarreal,La Liga,Carlos Romero,ESP,DF,21,2001,2.9,11,5,8,1,2,7,12,58.3,5,3,0,3,1,12,11,0,https://fbref.com/en/players/23cbf863/Carlos-Romero
2024,Villarreal,La Liga,Denis Suárez,ESP,"MF,FW",29,1994,1.5,0,0,0,0,0,0,2,0,2,2,2,0,0,0,4,0,https://fbref.com/en/players/12c50af5/Denis-Suarez
2024,Villarreal,La Liga,Alexander Sørloth,NOR,FW,27,1995,27.7,6,3,1,2,3,2,6,33.3,4,9,4,5,0,6,26,0,https://fbref.com/en/players/e92cd3f7/Alexander-Sorloth
2024,Villarreal,La Liga,Ramón Terrats,ESP,"MF,DF",22,2000,8.7,17,13,8,8,1,7,15,46.7,8,11,1,10,3,20,9,0,https://fbref.com/en/players/f36016a5/Ramon-Terrats
2024,Villarreal,La Liga,Bertrand Traoré,BFA,MF,27,1995,6.3,5,4,2,1,2,1,4,25,3,6,0,6,1,6,2,0,https://fbref.com/en/players/c47541e0/Bertrand-Traore
2024,Villarreal,La Liga,Manu Trigueros,ESP,MF,31,1991,3.4,7,5,6,1,0,4,10,40,6,1,1,0,3,10,9,0,https://fbref.com/en/players/963829d0/Manu-Trigueros
